GEOID,winner,votes_R_2020,votes_D_2020,votes_third_party_2020,votes_total_2020,republican,republican_Rate
01001,R,19838,7503,350,27691,1,0.7164060525080351
01003,R,83544,24578,1229,109351,1,0.7639985002423388
01005,R,5622,4816,68,10506,1,0.5351227869788692
01007,R,7525,1986,74,9585,1,0.7850808555033907
01009,R,24711,2640,209,27560,1,0.8966255442670537
01011,R,1146,3446,19,4611,1,0.24853610930383865
01013,R,5458,3965,59,9482,1,0.5756169584475849
01015,R,35101,15216,553,50870,1,0.690013760566149
01017,R,8753,6365,141,15259,1,0.5736286781571531
01019,R,10583,1624,82,12289,1,0.8611766620554968
01021,R,16085,3073,123,19281,1,0.8342409626056739
01023,R,4296,3127,38,7461,1,0.5757941294732609
01025,R,7324,5755,49,13128,1,0.5578915295551493
01027,R,5601,1267,53,6921,1,0.8092761161681837
01029,R,6484,675,60,7219,1,0.8981853442305029
01031,R,16899,5076,264,22239,1,0.7598812896263322
01033,R,19203,8343,272,27818,1,0.6903084333884535
01035,R,3442,2966,32,6440,1,0.534472049689441
01037,R,3631,1796,46,5473,1,0.6634386990681528
01039,R,14586,2721,97,17404,1,0.8380831992645369
01041,R,4864,1700,44,6608,1,0.7360774818401937
01043,R,36880,4478,418,41776,1,0.8828035235541938
01045,R,14303,5170,233,19706,1,0.725819547345986
01047,R,5524,12230,90,17844,1,0.30957184487783007
01049,R,24767,4281,250,29298,1,0.8453478053109428
01051,R,30164,10367,398,40929,1,0.7369835568912019
01053,R,10869,4918,94,15881,1,0.6844027454190542
01055,R,35528,11567,531,47626,1,0.7459790870532902
01057,R,7300,1395,56,8751,1,0.8341903782424865
01059,R,10376,2086,106,12568,1,0.8255887969446213
01061,R,10848,1595,90,12533,1,0.8655549349716748
01063,R,875,3884,8,4767,1,0.18355359765051396
01065,R,3192,4663,37,7892,1,0.40446021287379624
01067,R,6607,2606,69,9282,1,0.7118078000430942
01069,R,32618,12917,533,46068,1,0.7080402882695146
01071,R,19670,3717,208,23595,1,0.8336511972875609
01073,R,138843,181688,3578,324109,1,0.4283836610523003
01075,R,6174,978,33,7185,1,0.8592901878914405
01077,R,31721,11915,537,44173,1,0.718108346727639
01079,R,12322,3562,126,16010,1,0.7696439725171768
01081,R,42221,27860,1019,71100,1,0.5938255977496484
01083,R,34640,13672,748,49060,1,0.7060741948634325
01085,R,1836,4972,26,6834,1,0.26865671641791045
01087,R,1541,7108,52,8701,1,0.17710607976094703
01089,R,102780,87286,3699,193765,1,0.530436353314582
01091,R,5343,5488,59,10890,1,0.490633608815427
01093,R,12205,1463,115,13783,1,0.8855111369077849
01095,R,33191,5943,435,39569,1,0.8388132123632136
01097,R,101243,79474,1938,182655,1,0.554285401439873
01099,R,6147,4455,53,10655,1,0.5769122477709995
01101,R,33311,64529,923,98763,1,0.33728218057369663
01103,R,39664,13234,705,53603,1,0.7399585844075891
01105,R,1339,3860,24,5223,1,0.25636607313804327
01107,R,5594,4022,40,9656,1,0.5793289146644574
01109,R,8042,5636,134,13812,1,0.5822473211699971
01111,R,8559,2203,61,10823,1,0.7908158551233484
01113,R,9864,11228,198,21290,1,0.4633161108501644
01115,R,36166,7744,446,44356,1,0.8153575615474795
01117,R,79700,33268,1462,114430,1,0.6964956742113082
01119,R,1598,4648,37,6283,1,0.25433710011141175
01121,R,22235,13138,247,35620,1,0.6242279618192027
01123,R,14963,5859,130,20952,1,0.7141561664757541
01125,R,51117,37765,927,89809,1,0.5691745816120879
01127,R,26002,4834,277,31113,1,0.8357278308102722
01129,R,6564,2258,45,8867,1,0.7402729220705988
01131,R,1833,4048,17,5898,1,0.31078331637843337
01133,R,10195,974,102,11271,1,0.9045337592050395
04001,D,11442,23293,437,35172,0,0.3253155919481406
04003,D,35557,23732,1153,60442,0,0.5882829820323616
04005,D,27052,44698,1522,73272,0,0.3691996942897696
04007,D,18377,8943,342,27662,0,0.6643409731761984
04009,D,10749,4034,212,14995,0,0.7168389463154384
04011,D,2433,1182,70,3685,0,0.6602442333785618
04012,D,5129,2236,93,7458,0,0.6877178868329311
04013,D,995665,1040774,31705,2068144,0,0.4814292428380229
04015,D,78535,24831,1302,104668,0,0.750324836626285
04017,D,27657,23383,727,51767,0,0.534259277145672
04019,D,207758,304981,7658,520397,0,0.39922981877297525
04021,D,107077,75106,2791,184974,0,0.5788759501335323
04023,D,6194,13138,224,19556,0,0.3167314379218654
04025,D,91527,49602,2092,143221,0,0.6390613108412873
04027,D,36534,32210,1137,69881,0,0.5228030509008171
05001,R,4304,1818,79,6201,1,0.6940815997419771
05003,R,5548,2125,79,7752,1,0.7156862745098039
05005,R,15836,4635,330,20801,1,0.7613095524253641
05007,R,73965,42249,2556,118770,1,0.6227582722909826
05009,R,13652,3064,246,16962,1,0.8048579176983847
05011,R,2335,1214,49,3598,1,0.6489716509171762
05013,R,1636,479,31,2146,1,0.7623485554520038
05015,R,7424,4023,188,11635,1,0.6380747743876235
05017,R,1752,2260,33,4045,1,0.4331273176761434
05019,R,4616,3438,177,8231,1,0.5608067063540274
05021,R,4086,962,87,5135,1,0.795715676728335
05023,R,10328,1988,181,12497,1,0.8264383452028486
05025,R,2867,651,43,3561,1,0.8051109238977815
05027,R,5500,2814,190,8504,1,0.6467544684854186
05029,R,5694,2615,143,8452,1,0.6736867013724562
05031,R,25558,11921,660,38139,1,0.6701276908151761
05033,R,18607,4959,361,23927,1,0.7776570401638316
05035,R,7333,8514,203,16050,1,0.45688473520249223
05037,R,4946,1772,79,6797,1,0.7276739738119758
05039,R,1573,963,34,2570,1,0.6120622568093386
05041,R,1921,2016,48,3985,1,0.4820577164366374
05043,R,4349,2426,54,6829,1,0.6368428759701275
05045,R,34421,18347,1128,53896,1,0.638655929939142
05047,R,5677,1300,91,7068,1,0.8031975099037917
05049,R,3961,1035,59,5055,1,0.7835806132542038
05051,R,29069,14045,690,43804,1,0.6636151949593645
05053,R,6794,1268,80,8142,1,0.8344387128469664
05055,R,12670,3058,244,15972,1,0.7932632106185825
05057,R,4470,2138,83,6691,1,0.6680615752503363
05059,R,9202,3082,136,12420,1,0.740901771336554
05061,R,3367,1340,54,4761,1,0.7072043688300778
05063,R,11250,2806,212,14268,1,0.7884777123633305
05065,R,4631,1021,93,5745,1,0.8060922541340296
05067,R,3593,1365,68,5026,1,0.7148826104257859
05069,R,9521,14981,206,24708,1,0.3853407803140683
05071,R,6938,2283,151,9372,1,0.7402902262057192
05073,R,1757,839,21,2617,1,0.6713794421092855
05075,R,4569,1080,110,5759,1,0.7933669039763848
05077,R,1286,1423,40,2749,1,0.46780647508184797
05079,R,2729,1032,49,3810,1,0.7162729658792651
05081,R,3715,1226,138,5079,1,0.7314431974798189
05083,R,6441,1544,143,8128,1,0.7924458661417323
05085,R,22884,6686,592,30162,1,0.7587030037795902
05087,R,5658,1563,81,7302,1,0.7748562037797864
05089,R,5783,1531,102,7416,1,0.7798004314994607
05091,R,11920,4245,185,16350,1,0.7290519877675841
05093,R,7296,4558,203,12057,1,0.6051256531475492
05095,R,1545,1147,53,2745,1,0.5628415300546448
05097,R,3046,731,39,3816,1,0.7982180293501048
05099,R,2133,1076,83,3292,1,0.6479343863912516
05101,R,3192,709,53,3954,1,0.8072837632776935
05103,R,5294,3995,171,9460,1,0.5596194503171248
05105,R,3479,1012,72,4563,1,0.7624369932062239
05107,R,2417,3623,63,6103,1,0.39603473701458297
05109,R,3519,644,51,4214,1,0.8350735643094447
05111,R,5918,1424,96,7438,1,0.7956439903199785
05113,R,7035,1246,124,8405,1,0.8370017846519928
05115,R,18081,5772,351,24204,1,0.7470252850768468
05117,R,2786,654,27,3467,1,0.8035765791750793
05119,R,63687,101947,2436,168070,1,0.37893139763193906
05121,R,5355,1215,87,6657,1,0.804416403785489
05123,R,3242,3604,81,6927,1,0.46802367547278767
05125,R,39556,16060,821,56437,1,0.7008877155057852
05127,R,2962,483,51,3496,1,0.847254004576659
05129,R,3365,588,43,3996,1,0.8420920920920921
05131,R,31198,14487,1025,46710,1,0.6679083707985443
05133,R,3884,1116,126,5126,1,0.7577058134998049
05135,R,5938,1398,117,7453,1,0.7967261505434053
05137,R,4616,1180,90,5886,1,0.7842337750594631
05139,R,10478,5584,308,16370,1,0.6400733048259011
05141,R,6034,1593,87,7714,1,0.7822141560798548
05143,R,47504,43824,1911,93239,1,0.509486373727732
05145,R,24182,5978,494,30654,1,0.7888693155868728
05147,R,1543,856,29,2428,1,0.6355024711696869
05149,R,5226,1284,106,6616,1,0.7899032648125756
06001,D,136309,617659,15896,769864,0,0.1770559475439818
06003,D,244,476,21,741,0,0.3292847503373819
06005,D,13585,8153,564,22302,0,0.6091381938839566
06007,D,48730,50426,2886,102042,0,0.4775484604378589
06009,D,16518,10046,600,27164,0,0.6080842291267855
06011,D,4559,3239,163,7961,0,0.5726667504082402
06013,D,152877,416386,11967,581230,0,0.2630232438105397
06015,D,6461,4677,314,11452,0,0.5641809290953546
06017,D,61838,51621,2679,116138,0,0.5324527717026296
06019,D,164464,193025,7320,364809,0,0.45082221107483644
06021,D,7063,3995,234,11292,0,0.625487070492384
06023,D,21770,44768,2290,68828,0,0.3162956936130645
06025,D,20847,34678,1193,56718,0,0.3675552734581614
06027,D,4620,4634,227,9481,0,0.4872903702141124
06029,D,164484,133366,7376,305226,0,0.5388924927758448
06031,D,24072,18699,1087,43858,0,0.5488622372201195
06033,D,13123,14941,736,28800,0,0.45565972222222223
06035,D,8970,2799,216,11985,0,0.7484355444305382
06037,D,1145530,3028885,89028,4263443,0,0.2686865990702819
06039,D,29378,23168,1176,53722,0,0.5468523137634489
06041,D,24612,128288,2901,155801,0,0.15797074473206205
06043,D,5950,4088,242,10280,0,0.5787937743190662
06045,D,13267,28782,1287,43336,0,0.30614269891083623
06047,D,39397,48991,2153,90541,0,0.43512883665963487
06049,D,3109,1150,79,4338,0,0.7166897187644076
06051,D,2513,4013,211,6737,0,0.3730146949680867
06053,D,46299,113953,3631,163883,0,0.2825125241788349
06055,D,20676,49817,1629,72122,0,0.2866809018052744
06057,D,26779,36359,1600,64738,0,0.4136519509407149
06059,D,676498,814009,31218,1521725,0,0.4445599566281687
06061,D,122488,106869,5660,235017,0,0.5211878289655641
06063,D,6445,4561,250,11256,0,0.5725835110163469
06065,D,449144,528340,19523,997007,0,0.45049232352430824
06067,D,259405,440808,18077,718290,0,0.3611424355065503
06069,D,10590,17628,603,28821,0,0.36744040803580724
06071,D,366257,455859,18815,840931,0,0.4355375173468453
06073,D,600094,964650,36978,1601722,0,0.374655526989078
06075,D,56417,378156,8885,443458,0,0.1272206161575617
06077,D,121098,161137,6208,288443,0,0.419833381291971
06079,D,67436,88310,3935,159681,0,0.4223169945077999
06081,D,75584,291496,7091,374171,0,0.20200389661411494
06083,D,65736,129963,4589,200288,0,0.328207381370826
06085,D,214612,617967,17943,850522,0,0.2523297457326207
06087,D,26937,114246,3613,144796,0,0.18603414458962955
06089,D,60789,30000,2111,92900,0,0.6543487621097955
06091,D,1142,730,58,1930,0,0.5917098445595855
06093,D,13290,9593,567,23450,0,0.5667377398720682
06095,D,69306,131639,4886,205831,0,0.3367131287318237
06097,D,61825,199938,6489,268252,0,0.23047358453991024
06099,D,104145,105841,4890,214876,0,0.4846748822576742
06101,D,24375,17367,898,42640,0,0.5716463414634146
06103,D,19141,8911,669,28721,0,0.6664461543818112
06105,D,3188,2851,219,6258,0,0.5094279322467242
06107,D,77579,66105,3148,146832,0,0.5283521303258145
06109,D,17689,11978,734,30401,0,0.5818558600046051
06111,D,162207,251388,9103,422698,0,0.3837420569768487
06113,D,27292,67598,2374,97264,0,0.2805971376871196
06115,D,17676,11230,881,29787,0,0.593413233961124
08001,D,95657,134202,4915,234774,0,0.407442902536056
08003,D,3813,3759,124,7696,0,0.49545218295218296
08005,D,127323,213607,6858,347788,0,0.3660937122614926
08007,D,5189,3738,150,9077,0,0.5716646469097719
08009,D,1867,317,29,2213,0,0.8436511522819702
08011,D,1503,732,21,2256,0,0.6662234042553191
08013,D,42501,159089,3425,205015,0,0.20730678243055387
08014,D,16295,29077,940,46312,0,0.3518526515805839
08015,D,6222,7160,250,13632,0,0.4564260563380282
08017,D,993,131,6,1130,0,0.8787610619469026
08019,D,2754,3604,145,6503,0,0.42349684760879597
08021,D,2286,1959,44,4289,0,0.532991373280485
08023,D,741,1311,23,2075,0,0.3571084337349398
08025,D,1271,437,25,1733,0,0.7334102712060011
08027,D,2474,1112,38,3624,0,0.6826710816777042
08029,D,13081,5887,287,19255,0,0.6793560114256038
08031,D,71618,313293,6496,391407,0,0.18297577713224342
08033,D,1089,341,7,1437,0,0.7578288100208769
08035,D,121270,104653,4418,230341,0,0.52648030528651
08037,D,9892,18588,496,28976,0,0.3413859745996687
08039,D,14027,4490,363,18880,0,0.7429555084745763
08041,D,202828,161941,10945,375714,0,0.5398467983625843
08043,D,17517,7369,486,25372,0,0.6904067475957749
08045,D,14717,15427,562,30706,0,0.47928743568032306
08047,D,1833,2223,92,4148,0,0.44189971070395373
08049,D,4883,4710,215,9808,0,0.4978588907014682
08051,D,3735,7132,259,11126,0,0.3357001617832105
08053,D,353,255,11,619,0,0.5702746365105008
08055,D,2203,2076,86,4365,0,0.5046964490263459
08057,D,681,175,15,871,0,0.7818599311136625
08059,D,148417,218396,7974,374787,0,0.3960035967095977
08061,D,795,98,9,902,0,0.8813747228381374
08063,D,3144,662,39,3845,0,0.8176853055916775
08065,D,1497,2303,132,3932,0,0.38072227873855546
08067,D,14233,20548,694,35475,0,0.4012121212121212
08069,D,91489,126120,5112,222721,0,0.4107785076396029
08071,D,4284,3497,115,7896,0,0.5425531914893617
08073,D,2135,470,30,2635,0,0.8102466793168881
08075,D,8087,2218,160,10465,0,0.7727663640707119
08077,D,56894,31536,1589,90019,0,0.632022128661727
08079,D,427,317,3,747,0,0.571619812583668
08081,D,5670,1203,109,6982,0,0.812088226869092
08083,D,9306,5836,250,15392,0,0.6045997920997921
08085,D,16770,7687,358,24815,0,0.6758009268587548
08087,D,9593,3876,191,13660,0,0.7022693997071743
08089,D,5756,3605,120,9481,0,0.6071089547516085
08091,D,1577,2365,60,4002,0,0.39405297351324337
08093,D,6991,4903,308,12202,0,0.5729388624815605
08095,D,1958,486,32,2476,0,0.7907915993537964
08097,D,2780,8989,148,11917,0,0.23328018796677016
08099,D,4008,1458,55,5521,0,0.7259554428545554
08101,D,42252,43772,1553,87577,0,0.48245543921349215
08103,D,3061,561,48,3670,0,0.8340599455040872
08105,D,3660,2495,83,6238,0,0.5867265149086246
08107,D,5925,10582,289,16796,0,0.35276256251488447
08109,D,1413,1884,57,3354,0,0.4212880143112701
08111,D,202,342,11,555,0,0.36396396396396397
08113,D,1136,3924,68,5128,0,0.22152886115444617
08115,D,1121,301,11,1433,0,0.782274947662247
08117,D,5322,12631,431,18384,0,0.28949086161879894
08119,D,11241,5278,309,16828,0,0.6679938198241027
08121,D,2595,369,33,2997,0,0.8658658658658659
08123,D,96145,66060,3486,165691,0,0.5802668823291549
08125,D,4107,785,58,4950,0,0.8296969696969697
09001,D,169039,297505,6274,472818,0,0.3575138848351797
09003,D,159024,283368,6812,449204,0,0.3540128761097408
09005,D,55601,50164,1765,107530,0,0.5170743048451595
09007,D,40665,56848,1654,99167,0,0.41006584851815625
09009,D,169892,242629,5354,417875,0,0.40656177086449297
09011,D,57110,79459,3013,139582,0,0.4091501769569142
09013,D,34819,44006,1672,80497,0,0.43255028137694573
09015,D,29141,26701,1221,57063,0,0.5106811769447803
10001,D,41009,44552,1464,87025,0,0.47123240448147086
10003,D,88364,195034,4235,287633,0,0.3072109250329413
10005,D,71230,56682,1440,129352,0,0.5506679448327045
11001,D,18586,317323,4455,340364,0,0.054606245078797994
12001,R,50972,89704,1908,142584,1,0.3574875161308422
12003,R,11911,2037,111,14059,1,0.8472153069208336
12005,R,66097,25614,1297,93008,1,0.7106592981248925
12007,R,10334,3160,137,13631,1,0.7581248624458954
12009,R,207883,148549,4288,360720,1,0.5763001774229319
12011,R,333409,618752,5448,957609,1,0.3481681980850222
12013,R,5274,1209,43,6526,1,0.8081520073551947
12015,R,73243,42273,820,116336,1,0.6295815568697566
12017,R,65352,27092,755,93199,1,0.701209240442494
12019,R,84480,38317,1596,124393,1,0.6791378936113769
12021,R,128950,77621,1228,207799,1,0.6205515907198783
12023,R,23836,8914,292,33042,1,0.7213849040614975
12027,R,8313,4259,87,12659,1,0.6566869420965321
12029,R,6759,1365,43,8167,1,0.8275988735153668
12031,R,233762,252556,6425,492743,1,0.47440958065360644
12033,R,96674,70929,2736,170339,1,0.5675388490011095
12035,R,43043,28161,507,71711,1,0.6002286957370557
12037,R,4675,2120,54,6849,1,0.6825813987443422
12039,R,7465,16153,144,23762,1,0.31415705748674355
12041,R,7895,1700,87,9682,1,0.8154306961371618
12043,R,3782,1385,26,5193,1,0.7282880801078375
12045,R,6113,1985,65,8163,1,0.7488668381722406
12047,R,3815,1963,51,5829,1,0.6544861897409504
12049,R,6122,2298,65,8485,1,0.7215085444902769
12051,R,7906,4929,104,12939,1,0.6110209444315635
12053,R,70412,37519,983,108914,1,0.6464917274179628
12055,R,34873,16938,356,52167,1,0.6684877412923879
12057,R,327398,376367,8225,711990,1,0.4598351100436804
12059,R,8080,924,64,9068,1,0.8910454344949272
12061,R,58872,37844,765,97481,1,0.6039330741375243
12063,R,15488,6766,160,22414,1,0.690996698492014
12065,R,4479,3897,72,8448,1,0.5301846590909091
12067,R,3128,510,20,3658,1,0.8551120831055221
12069,R,125859,83505,1934,211298,1,0.5956469062650853
12071,R,233247,157695,2940,393882,1,0.5921748137767149
12073,R,57453,103517,1906,162876,1,0.352740735283283
12075,R,16749,6205,190,23144,1,0.7236864846180435
12077,R,2846,694,21,3561,1,0.7992137040157259
12079,R,5576,3747,57,9380,1,0.594456289978678
12081,R,124987,90166,1788,216941,1,0.5761336031455557
12083,R,127826,74858,1677,204361,1,0.6254911651440344
12085,R,61168,36893,663,98724,1,0.6195859162918844
12086,R,532833,617864,6092,1156789,1,0.46061381980637783
12087,R,25693,21881,451,48025,1,0.5349921915668923
12089,R,42566,15564,676,58806,1,0.7238377036356834
12091,R,79798,34248,2292,116338,1,0.6859151781876944
12093,R,11470,4390,93,15953,1,0.7189870243841284
12095,R,245398,395014,6884,647296,1,0.3791124925845363
12097,R,73480,97297,1630,172407,1,0.42620079231121705
12099,R,334711,433572,4810,773093,1,0.4329504988403724
12101,R,179621,119073,3243,301937,1,0.5948956239215466
12103,R,276209,277450,5995,559654,1,0.49353529144793035
12105,R,194586,145049,3581,343216,1,0.5669490932823644
12107,R,25514,10527,331,36372,1,0.7014736610579567
12109,R,110946,63850,1822,176618,1,0.6281692692704028
12111,R,86831,84137,1191,172159,1,0.5043651508198816
12113,R,77385,27612,1928,106925,1,0.7237315875613748
12115,R,148370,120110,2068,270548,1,0.5484054585507933
12117,R,125241,132528,2996,260765,1,0.48028301344122104
12119,R,62761,29341,382,92484,1,0.6786146792958782
12121,R,16410,4485,162,21057,1,0.7793132924918079
12123,R,7751,2299,75,10125,1,0.7655308641975309
12125,R,5133,1053,59,6245,1,0.821937550040032
12127,R,173821,130575,3020,307416,1,0.5654260025502902
12129,R,12874,5351,179,18404,1,0.6995218430775918
12131,R,32947,10338,423,43708,1,0.7537979317287453
12133,R,9876,2347,104,12327,1,0.8011681674373327
13001,D,6570,1784,36,8390,0,0.7830750893921334
13003,D,2300,825,30,3155,0,0.7290015847860539
13005,D,4017,625,25,4667,0,0.8607242339832869
13007,D,897,652,6,1555,0,0.5768488745980708
13009,D,8903,9140,208,18251,0,0.48780888718426385
13011,D,7795,932,74,8801,0,0.885694807408249
13013,D,26804,10453,664,37921,0,0.7068378998444134
13015,D,37672,12091,701,50464,0,0.7465123652504756
13017,D,4111,2393,60,6564,0,0.6262949421084705
13019,D,6419,1269,55,7743,0,0.8290068448921607
13021,D,26559,43408,747,70714,0,0.3755833356902452
13023,D,4329,1312,67,5708,0,0.7584092501751927
13025,D,6993,700,56,7749,0,0.9024390243902439
13027,D,4261,2791,49,7101,0,0.6000563300943529
13029,D,14240,6738,357,21335,0,0.6674478556362784
13031,D,18387,11248,455,30090,0,0.6110667996011964
13033,D,5400,5208,75,10683,0,0.5054759898904801
13035,D,8406,3274,91,11771,0,0.71412794155127
13037,D,923,1263,12,2198,0,0.41992720655141036
13039,D,15249,7967,470,23686,0,0.6437980241492866
13043,D,3133,1269,29,4431,0,0.707063868201309
13045,D,37476,16236,760,54472,0,0.6879864884711412
13047,D,25167,6932,494,32593,0,0.7721596661859909
13049,D,3419,1105,44,4568,0,0.7484676007005254
13051,D,53232,78247,1929,133408,0,0.3990165507315903
13053,D,880,667,35,1582,0,0.5562579013906448
13055,D,8064,1854,132,10050,0,0.8023880597014925
13057,D,99585,42779,2451,144815,0,0.6876704761247109
13059,D,14450,36055,841,51346,0,0.28142406419195265
13061,D,637,791,7,1435,0,0.44390243902439025
13063,D,15811,95466,1053,112330,0,0.14075491854357697
13065,D,2105,744,12,2861,0,0.7357567284166375
13067,D,165436,221847,6445,393728,0,0.42017839726918077
13069,D,10578,4511,125,15214,0,0.6952806625476535
13071,D,11777,4190,119,16086,0,0.7321273156782295
13073,D,50013,29232,1330,80575,0,0.6207012100527459
13075,D,4900,2059,76,7035,0,0.6965174129353234
13077,D,51501,24210,1088,76799,0,0.6705946692014219
13079,D,4428,1615,59,6102,0,0.7256637168141593
13081,D,4985,2982,66,8033,0,0.6205651686791983
13083,D,6066,1261,107,7434,0,0.8159806295399515
13085,D,13398,2486,197,16081,0,0.833157141968783
13087,D,6755,4782,88,11625,0,0.5810752688172043
13089,D,58377,308162,4207,370746,0,0.1574582058875888
13091,D,5843,2172,56,8071,0,0.7239499442448272
13093,D,2159,1911,35,4105,0,0.5259439707673569
13095,D,10441,24568,278,35287,0,0.29588800408082294
13097,D,25454,42814,838,69106,0,0.3683327062773131
13099,D,2710,2450,28,5188,0,0.5223592906707787
13101,D,1256,167,18,1441,0,0.871616932685635
13103,D,23361,7718,492,31571,0,0.7399512210572994
13105,D,6226,2879,66,9171,0,0.6788790753462
13107,D,6553,2886,66,9505,0,0.6894266175697001
13109,D,2888,1324,35,4247,0,0.6800094184129974
13111,D,12169,2570,110,14849,0,0.8195164657552697
13113,D,37956,33062,976,71994,0,0.527210600883407
13115,D,28906,11917,518,41341,0,0.6992090176822041
13117,D,85123,42208,1980,129311,0,0.65828119804193
13119,D,9069,1593,103,10765,0,0.8424523920111472
13121,D,137247,380212,6320,523779,0,0.2620322693349676
13123,D,13429,2932,164,16525,0,0.8126475037821482
13125,D,1402,155,8,1565,0,0.8958466453674121
13127,D,25617,15882,489,41988,0,0.6101028865390111
13129,D,19405,4384,244,24033,0,0.8074314484250822
13131,D,7034,3619,54,10707,0,0.6569533949752498
13133,D,7066,4087,91,11244,0,0.6284240483813589
13135,D,166400,241994,5629,414023,0,0.4019100388142688
13137,D,16637,3562,232,20431,0,0.8143017962899516
13139,D,64183,25033,1321,90537,0,0.7089145874062538
13141,D,1154,2976,23,4153,0,0.2778714182518661
13143,D,12330,1791,125,14246,0,0.8655061069773972
13145,D,14319,5457,215,19991,0,0.7162723225451453
13147,D,9465,3157,106,12728,0,0.7436360779384035
13149,D,4519,824,51,5394,0,0.8377827215424546
13151,D,48259,73443,1296,122998,0,0.39235597326785804
13153,D,41540,32239,1059,74838,0,0.5550656083807691
13155,D,3134,1008,26,4168,0,0.7519193857965452
13157,D,29502,7642,531,37675,0,0.7830656934306569
13159,D,5822,1761,61,7644,0,0.7616431187859759
13161,D,4695,1028,48,5771,0,0.8135505111765725
13163,D,3537,4058,44,7639,0,0.463018719727713
13165,D,2161,1266,28,3455,0,0.6254703328509407
13167,D,2850,1222,28,4100,0,0.6951219512195121
13169,D,9940,4882,112,14934,0,0.6655952859247355
13171,D,6331,2620,94,9045,0,0.6999447208402432
13173,D,2509,1019,48,3576,0,0.7016219239373602
13175,D,14493,8074,164,22731,0,0.6375874356605516
13177,D,12007,4558,149,16714,0,0.7183798013641259
13179,D,7959,13104,331,21394,0,0.37202019257735813
13181,D,3173,1432,36,4641,0,0.6836888601594484
13183,D,3527,2035,95,5657,0,0.6234753402863709
13185,D,25692,20116,547,46355,0,0.5542444180778773
13187,D,12163,3126,242,15531,0,0.7831433906380787
13189,D,6169,4168,118,10455,0,0.5900526064084171
13191,D,4016,2612,68,6696,0,0.5997610513739546
13193,D,1783,2858,22,4663,0,0.3823718636071199
13195,D,11326,3411,200,14937,0,0.7582513222199906
13197,D,2275,1312,38,3625,0,0.6275862068965518
13199,D,6524,4287,66,10877,0,0.5997977383469707
13201,D,2066,748,20,2834,0,0.7290049400141143
13205,D,4935,3993,34,8962,0,0.5506583351930373
13207,D,11057,4385,148,15590,0,0.7092366901860166
13209,D,2960,980,27,3967,0,0.7461557852281321
13211,D,8231,3353,122,11706,0,0.7031436869981206
13213,D,12944,2301,144,15389,0,0.8411202807199948
13215,D,30107,49446,961,80514,0,0.37393496783168145
13217,D,23869,29789,576,54234,0,0.44011136925176086
13219,D,16595,8162,411,25168,0,0.6593690400508583
13221,D,5592,2439,102,8133,0,0.6875691626706013
13223,D,54517,29695,1160,85372,0,0.6385817364006935
13225,D,6506,5922,125,12553,0,0.5182824822751534
13227,D,14110,2824,233,17167,0,0.8219257878487797
13229,D,7898,1100,49,9047,0,0.8729965734497623
13231,D,9127,1505,88,10720,0,0.8513992537313433
13233,D,13587,3657,152,17396,0,0.781041618762934
13235,D,2815,1230,36,4081,0,0.6897819161970106
13237,D,8291,3448,116,11855,0,0.699367355546183
13239,D,604,497,5,1106,0,0.546112115732369
13241,D,7474,1984,110,9568,0,0.7811454849498328
13243,D,1390,1671,12,3073,0,0.4523267165636186
13245,D,26780,59119,1110,87009,0,0.307784252203795
13247,D,13014,31237,430,44681,0,0.29126474340323627
13249,D,1800,462,13,2275,0,0.7912087912087912
13251,D,3915,2661,51,6627,0,0.5907650520597555
13253,D,2613,1256,19,3888,0,0.6720679012345679
13255,D,18104,11828,279,30211,0,0.5992519281056569
13257,D,9367,2386,132,11885,0,0.7881363062684056
13259,D,801,1182,7,1990,0,0.40251256281407033
13261,D,5733,6314,101,12148,0,0.47192953572604546
13263,D,1392,2114,16,3522,0,0.39522998296422485
13265,D,360,561,7,928,0,0.3879310344827586
13267,D,6054,2062,69,8185,0,0.7396456933414783
13269,D,2420,1388,34,3842,0,0.6298802706923478
13271,D,2825,1488,21,4334,0,0.6518227964928472
13273,D,2004,2376,36,4416,0,0.453804347826087
13275,D,12969,8708,195,21872,0,0.5929498902706657
13277,D,10784,5318,177,16279,0,0.6624485533509429
13279,D,7873,2938,103,10914,0,0.7213670514934946
13281,D,6384,1550,45,7979,0,0.800100263190876
13283,D,2101,952,24,3077,0,0.682807929801755
13285,D,18142,11577,328,30047,0,0.6037873997404067
13287,D,2349,1409,33,3791,0,0.619625428646795
13289,D,2370,2044,30,4444,0,0.5333033303330333
13291,D,12650,2800,108,15558,0,0.813086514976218
13293,D,8606,4203,96,12905,0,0.6668733049205734
13295,D,23173,5770,411,29354,0,0.7894324453226136
13297,D,37839,12683,571,51093,0,0.7405906875697258
13299,D,9903,4169,117,14189,0,0.6979350200859821
13301,D,1166,1468,16,2650,0,0.44
13303,D,4668,4743,66,9477,0,0.49256093700538145
13305,D,9987,2688,104,12779,0,0.781516550590813
13307,D,748,640,3,1391,0,0.5377426312005751
13309,D,1583,689,13,2285,0,0.6927789934354486
13311,D,12222,2411,183,14816,0,0.8249190064794817
13313,D,25644,10680,442,36766,0,0.6974922482728608
13315,D,2402,861,16,3279,0,0.7325404086611772
13317,D,2823,2160,47,5030,0,0.5612326043737574
13319,D,2665,2074,31,4770,0,0.5587002096436059
13321,D,6830,2395,60,9285,0,0.7355950457727517
15001,D,26897,58731,2186,87814,0,0.3062951237843624
15003,D,136259,238869,6986,382114,0,0.3565925352120048
15007,D,11582,21225,690,33497,0,0.3457623070722751
15009,D,22126,47305,1613,71044,0,0.311440797252407
16001,R,130699,120539,6104,257342,1,0.5078805636079614
16003,R,1941,591,43,2575,1,0.7537864077669902
16005,R,23331,14682,1123,39136,1,0.5961518806214228
16007,R,2914,350,36,3300,1,0.883030303030303
16009,R,3878,977,73,4928,1,0.7869318181818182
16011,R,15295,4124,412,19831,1,0.7712672079068126
16013,R,4032,8919,249,13200,1,0.3054545454545455
16015,R,3485,1204,86,4775,1,0.7298429319371728
16017,R,18369,8310,494,27173,1,0.6760019136642991
16019,R,37805,14254,1491,53550,1,0.7059757236227825
16021,R,4937,1220,125,6282,1,0.7858962113976441
16023,R,1202,188,18,1408,1,0.8536931818181818
16025,R,507,149,92,748,1,0.6778074866310161
16027,R,61759,25881,2123,89763,1,0.6880229047603132
16029,R,2906,431,57,3394,1,0.8562168532704774
16031,R,7907,1464,184,9555,1,0.8275248560962847
16033,R,264,41,4,309,1,0.8543689320388349
16035,R,3453,877,61,4391,1,0.7863812343429742
16037,R,2089,603,25,2717,1,0.7688627162311373
16039,R,7246,2601,277,10124,1,0.7157250098775187
16041,R,5845,657,122,6624,1,0.882397342995169
16043,R,5548,998,118,6664,1,0.8325330132052821
16045,R,7951,1803,150,9904,1,0.8028069466882067
16047,R,4659,1256,96,6011,1,0.7750790217933788
16049,R,7826,1561,157,9544,1,0.8199916177703269
16051,R,12099,1661,328,14088,1,0.8588160136286201
16053,R,5734,1893,127,7754,1,0.7394892958473046
16055,R,62837,24312,1855,89004,1,0.7060019774392162
16057,R,9472,10236,683,20391,1,0.4645186601932225
16059,R,3592,1032,93,4717,1,0.761500953996184
16061,R,1489,349,25,1863,1,0.799248523886205
16063,R,1469,414,31,1914,1,0.7675026123301986
16065,R,13559,2666,748,16973,1,0.7988570081894774
16067,R,6265,1550,116,7931,1,0.7899382171226832
16069,R,13738,6686,371,20795,1,0.6606395768213513
16071,R,2148,249,38,2435,1,0.8821355236139631
16073,R,3819,816,80,4715,1,0.8099681866383881
16075,R,8862,2161,202,11225,1,0.7894877505567929
16077,R,2116,865,64,3045,1,0.6949096880131362
16079,R,4216,1693,95,6004,1,0.7021985343104596
16081,R,2858,3318,115,6291,1,0.45429979335558734
16083,R,25897,9391,923,36211,1,0.7151694236557952
16085,R,3947,2976,89,7012,1,0.5628921848260126
16087,R,4154,1073,76,5303,1,0.7833301904582312
17001,D,24220,8633,610,33463,0,0.7237844783791053
17003,D,1486,1114,12,2612,0,0.5689127105666156
17005,D,5625,2288,209,8122,0,0.6925634080275794
17007,D,13883,10542,528,24953,0,0.5563659680198774
17009,D,1931,486,65,2482,0,0.7780016116035455
17011,D,10411,6669,317,17397,0,0.5984365120423062
17013,D,2046,677,45,2768,0,0.7391618497109826
17015,D,5105,2748,160,8013,0,0.6370897291900661
17017,D,3625,1615,71,5311,0,0.682545659951045
17019,D,35285,57067,2412,94764,0,0.3723460385800515
17021,D,11563,4335,283,16181,0,0.7146035473703727
17023,D,6226,1993,127,8346,0,0.745986101126288
17025,D,5629,1129,118,6876,0,0.8186445607911577
17027,D,14304,4493,350,19147,0,0.7470622029560766
17029,D,14037,8067,467,22571,0,0.62190421337114
17031,D,558269,1725973,33021,2317263,0,0.240917409892619
17033,D,7043,2202,170,9415,0,0.7480616038236856
17035,D,4601,1142,85,5828,0,0.7894646533973919
17037,D,21905,24643,1168,47716,0,0.45907033280241427
17039,D,5632,2191,189,8012,0,0.7029455816275587
17041,D,6227,2335,166,8728,0,0.7134509624197983
17043,D,193611,281222,9116,483949,0,0.40006488286988917
17045,D,6193,1887,108,8188,0,0.7563507572056668
17047,D,2833,488,42,3363,0,0.8424026167112697
17049,D,15006,3716,300,19022,0,0.7888760382714751
17051,D,8055,1826,156,10037,0,0.8025306366444157
17053,D,5048,1754,141,6943,0,0.7270632291516635
17055,D,13622,4760,232,18614,0,0.7318147630815515
17057,D,9867,6503,286,16656,0,0.5923991354466859
17059,D,2019,622,30,2671,0,0.7558966679146387
17061,D,4770,1349,97,6216,0,0.7673745173745173
17063,D,16523,9626,507,26656,0,0.619860444177671
17065,D,3432,824,55,4311,0,0.7961029923451636
17067,D,6906,2315,154,9375,0,0.73664
17069,D,1691,449,21,2161,0,0.7825080981027303
17071,D,2394,1187,62,3643,0,0.65715069997255
17073,D,15300,9797,495,25592,0,0.5978430759612379
17075,D,10877,2908,215,14000,0,0.7769285714285714
17077,D,10890,11181,538,22609,0,0.4816665929497103
17079,D,4494,1007,71,5572,0,0.8065326633165829
17081,D,12476,4608,304,17388,0,0.7175063262019784
17083,D,8712,2961,254,11927,0,0.7304435314831894
17085,D,7166,5109,202,12477,0,0.5743367796746013
17087,D,5059,1281,93,6433,0,0.7864138038240324
17089,D,96775,130166,4379,231320,0,0.4183598478298461
17091,D,28532,20271,1039,49842,0,0.5724489386461218
17093,D,29492,33168,1209,63869,0,0.4617576602107439
17095,D,12009,10703,395,23107,0,0.519712641190981
17097,D,123594,204032,5977,333603,0,0.370482279835613
17099,D,30113,22442,981,53536,0,0.5624813209802749
17101,D,4886,1419,103,6408,0,0.7624843945068664
17103,D,9630,6407,338,16375,0,0.5880916030534351
17105,D,12208,4615,329,17152,0,0.7117537313432836
17107,D,9136,3840,291,13267,0,0.6886259139217608
17109,D,7027,4992,246,12265,0,0.5729311047696698
17111,D,82260,78154,3162,163576,0,0.5028855088766078
17113,D,40502,43933,2282,86717,0,0.4670595154352664
17115,D,28589,19847,867,49303,0,0.5798632943228607
17117,D,16153,7365,480,23998,0,0.6730977581465122
17119,D,76031,57836,3062,136929,0,0.5552585646575963
17121,D,12678,4524,246,17448,0,0.7266162310866575
17123,D,4197,2005,126,6328,0,0.6632427307206068
17125,D,4654,1985,116,6755,0,0.6889711324944485
17127,D,4997,1725,84,6806,0,0.7342051131354687
17129,D,4764,2022,133,6919,0,0.688538806185865
17131,D,5418,3280,187,8885,0,0.6097917839054586
17133,D,14142,6569,409,21120,0,0.6696022727272727
17135,D,9544,3905,264,13713,0,0.6959819149711952
17137,D,9950,5076,268,15294,0,0.6505819275532889
17139,D,4964,1662,114,6740,0,0.7364985163204748
17141,D,16248,9428,555,26231,0,0.6194197705005527
17143,D,38252,43578,1921,83751,0,0.4567348449570751
17145,D,7313,2612,124,10049,0,0.7277341028958105
17147,D,6248,3329,217,9794,0,0.6379415968960588
17149,D,6332,1484,129,7945,0,0.796979232221523
17151,D,1722,433,20,2175,0,0.7917241379310345
17153,D,1699,891,30,2620,0,0.648473282442748
17155,D,1993,1338,52,3383,0,0.5891220809932013
17157,D,11076,3592,206,14874,0,0.7446551028640581
17159,D,6089,1830,135,8054,0,0.7560218524956543
17161,D,28603,36691,1357,66651,0,0.42914584927457955
17163,D,57150,68325,2428,127903,0,0.4468229830418364
17165,D,8103,2789,163,11055,0,0.7329715061058345
17167,D,53485,48917,2184,104586,0,0.5113973189528235
17169,D,2773,1068,62,3903,0,0.7104791186266974
17171,D,2114,572,46,2732,0,0.773792093704246
17173,D,9426,2504,159,12089,0,0.7797170981884358
17175,D,2004,815,61,2880,0,0.6958333333333333
17177,D,12521,9055,443,22019,0,0.5686452609110314
17179,D,42513,24819,1571,68903,0,0.6169978085134175
17181,D,6161,2579,132,8872,0,0.6944319206492335
17183,D,20725,10323,497,31545,0,0.6569979394515771
17185,D,4237,1253,97,5587,0,0.7583676391623412
17187,D,4676,3090,138,7904,0,0.5915991902834008
17189,D,6115,1641,137,7893,0,0.7747371088306094
17191,D,7176,1187,116,8479,0,0.8463262177143531
17193,D,5791,1517,108,7416,0,0.7808791801510249
17195,D,14527,12253,558,27338,0,0.5313848855073524
17197,D,155116,183915,5605,344636,0,0.45008646804164393
17199,D,22801,10206,613,33620,0,0.67819750148721
17201,D,60861,64056,2537,127454,0,0.4775134558350464
17203,D,14799,6160,434,21393,0,0.6917683354368251
18001,R,10686,3236,287,14209,1,0.7520585544373285
18003,R,92083,73189,3728,169000,1,0.5448698224852071
18005,R,22410,12934,872,36216,1,0.6187872763419483
18007,R,3007,1009,92,4108,1,0.7319863680623174
18009,R,3841,1376,132,5349,1,0.7180781454477473
18011,R,22351,15244,905,38500,1,0.5805454545454546
18013,R,5777,3036,168,8981,1,0.643246854470549
18015,R,7086,2224,185,9495,1,0.7462875197472354
18017,R,10552,4304,333,15189,1,0.6947132793468958
18019,R,33668,23093,1108,57869,1,0.5817968169486254
18021,R,9499,2552,208,12259,1,0.774859287054409
18023,R,9334,3361,246,12941,1,0.7212734719109806
18025,R,3483,1355,106,4944,1,0.7044902912621359
18027,R,9576,2169,204,11949,1,0.8014059753954306
18029,R,19528,5446,387,25361,1,0.7700011829186546
18031,R,9575,2439,273,12287,1,0.7792789126719297
18033,R,14237,4966,425,19628,1,0.7253413490931323
18035,R,26827,20474,890,48191,1,0.5566807080160195
18037,R,15033,6292,432,21757,1,0.6909500390678862
18039,R,46972,26108,1241,74321,1,0.6320151774061167
18041,R,7755,2237,144,10136,1,0.7650947119179163
18043,R,23400,17511,850,41761,1,0.5603314096884653
18045,R,6154,1629,200,7983,1,0.770888137291745
18047,R,9691,2137,169,11997,1,0.8077852796532466
18049,R,6694,2280,170,9144,1,0.7320647419072616
18051,R,11817,4023,321,16161,1,0.7312047521811769
18053,R,18543,8015,584,27142,1,0.6831847321494363
18055,R,11103,3389,290,14782,1,0.7511162224326884
18057,R,101587,88390,3894,193871,1,0.5239927580710885
18059,R,28996,12895,1016,42907,1,0.6757871675950311
18061,R,14565,5343,323,20231,1,0.7199347535959666
18063,R,53802,32604,2052,88458,1,0.6082208505731533
18065,R,15043,5544,434,21021,1,0.7156177156177156
18067,R,26449,13303,858,40610,1,0.6512927850283181
18069,R,13147,4255,408,17810,1,0.738180797304885
18071,R,14555,4302,381,19238,1,0.7565755276016218
18073,R,11383,3798,288,15469,1,0.7358588144029995
18075,R,6361,1926,169,8456,1,0.7522469252601703
18077,R,9663,4731,296,14690,1,0.6577944179714091
18079,R,9490,2523,238,12251,1,0.774630642396539
18081,R,51219,24736,1618,77573,1,0.6602683923530094
18083,R,11655,4067,282,16004,1,0.7282554361409648
18085,R,26499,8364,903,35766,1,0.74089917799027
18087,R,8110,2355,168,10633,1,0.7627198344775699
18089,R,91760,124870,3212,219842,1,0.41739067148224634
18091,R,25997,22427,968,49392,1,0.5263402980239715
18093,R,15601,4961,463,21025,1,0.7420214030915576
18095,R,31215,19524,1026,51765,1,0.6030136192407998
18097,R,134175,247772,7228,389175,1,0.34476777799190594
18099,R,13844,5712,362,19918,1,0.6950497037855207
18101,R,4029,1011,104,5144,1,0.7832426127527217
18103,R,10925,3235,306,14466,1,0.7552191345223283
18105,R,22071,39861,1105,63037,1,0.3501277027777337
18107,R,12659,4213,326,17198,1,0.736073962088615
18109,R,27512,7781,862,36155,1,0.7609459272576408
18111,R,4942,1509,140,6591,1,0.7498103474434835
18113,R,14195,4660,335,19190,1,0.7397081813444503
18115,R,2054,668,353,3075,1,0.6679674796747967
18117,R,6432,2224,174,8830,1,0.7284258210645527
18119,R,7286,2420,198,9904,1,0.7356623586429726
18121,R,5400,1503,110,7013,1,0.7699985740767147
18123,R,5345,3203,174,8722,1,0.6128181609722541
18125,R,4692,1415,113,6220,1,0.7543408360128617
18127,R,45008,39746,1656,86410,1,0.5208656405508622
18129,R,9206,3811,214,13231,1,0.6957901897059935
18131,R,4246,1463,97,5806,1,0.7313124354116431
18133,R,12278,3946,371,16595,1,0.7398614040373607
18135,R,8312,2513,243,11068,1,0.7509938561619082
18137,R,11261,2774,229,14264,1,0.789469994391475
18139,R,6035,1754,143,7932,1,0.7608421583459405
18141,R,53164,59896,1925,114985,1,0.46235595947297475
18143,R,7328,2698,134,10160,1,0.721259842519685
18145,R,14568,5023,400,19991,1,0.7287279275674053
18147,R,7357,3213,199,10769,1,0.6831646392422694
18149,R,7466,2650,174,10290,1,0.7255587949465501
18151,R,11327,4513,312,16152,1,0.7012753838533927
18153,R,6691,2153,150,8994,1,0.7439404047142539
18155,R,3133,964,55,4152,1,0.7545761078998073
18157,R,34581,35017,1832,71430,1,0.4841243175136497
18159,R,6110,1834,171,8115,1,0.7529266789895256
18161,R,2688,736,59,3483,1,0.7717484926787253
18163,R,41844,34415,1322,77581,1,0.5393588636392931
18165,R,5184,2145,151,7480,1,0.6930481283422459
18167,R,24545,18123,900,43568,1,0.5633721997796548
18169,R,10762,3494,317,14573,1,0.73848898648185
18171,R,3401,974,96,4471,1,0.7606799373741893
18173,R,21326,11923,557,33806,1,0.6308347630598119
18175,R,9114,2784,233,12131,1,0.7512983266012695
18177,R,17567,9524,571,27662,1,0.6350589256019088
18179,R,10855,2928,261,14044,1,0.772927940757619
18181,R,7957,3032,170,11159,1,0.7130567255130388
18183,R,12862,4234,453,17549,1,0.7329192546583851
19001,R,2917,1198,44,4159,1,0.7013705217600384
19003,R,1530,590,31,2151,1,0.7112970711297071
19005,R,4735,2576,93,7404,1,0.6395191788222583
19007,R,4512,1891,92,6495,1,0.6946882217090069
19009,R,2295,1071,46,3412,1,0.6726260257913247
19011,R,9188,5160,242,14590,1,0.6297464016449623
19013,R,29640,35647,933,66220,1,0.4475989127151918
19015,R,8695,6303,259,15257,1,0.5699023399095497
19017,R,8294,5958,236,14488,1,0.5724737713970183
19019,R,6420,4169,139,10728,1,0.598434004474273
19021,R,5056,2961,97,8114,1,0.6231205324131132
19023,R,5542,2424,101,8067,1,0.6869964051072269
19025,R,3689,1470,75,5234,1,0.7048146732900268
19027,R,7737,3454,91,11282,1,0.6857826626484665
19029,R,4969,2201,81,7251,1,0.6852847883050613
19031,R,6161,4337,164,10662,1,0.5778465578690677
19033,R,12442,10941,277,23660,1,0.5258664412510566
19035,R,4495,1936,58,6489,1,0.6927107412544306
19037,R,4308,2233,68,6609,1,0.651838402178847
19039,R,3144,1466,42,4652,1,0.6758383490971626
19041,R,6137,2662,125,8924,1,0.6876961004034066
19043,R,6106,3340,116,9562,1,0.6385693369587953
19045,R,13361,10812,409,24582,1,0.5435277845578065
19047,R,4854,2220,59,7133,1,0.6804990887424646
19049,R,27987,26879,856,55722,1,0.5022612253687951
19051,R,3032,1013,42,4087,1,0.7418644482505505
19053,R,2615,1120,49,3784,1,0.6910676532769556
19055,R,6666,3157,134,9957,1,0.6694787586622477
19057,R,10592,8893,363,19848,1,0.5336557839580814
19059,R,7438,3661,117,11216,1,0.6631597717546363
19061,R,27214,25657,766,53637,1,0.5073736413296791
19063,R,3265,1520,56,4841,1,0.6744474282173105
19065,R,6145,3835,151,10131,1,0.6065541407560952
19067,R,4732,3172,94,7998,1,0.5916479119779945
19069,R,3422,1626,60,5108,1,0.6699295223179327
19071,R,2711,1080,48,3839,1,0.7061734826777807
19073,R,3223,1769,50,5042,1,0.639230464101547
19075,R,4929,2206,113,7248,1,0.6800496688741722
19077,R,4272,1985,93,6350,1,0.672755905511811
19079,R,4956,2843,100,7899,1,0.6274211925560198
19081,R,4390,1683,69,6142,1,0.714750895473787
19083,R,5850,2976,132,8958,1,0.6530475552578701
19085,R,5569,2440,110,8119,1,0.6859219115654638
19087,R,6507,3275,161,9943,1,0.6544302524389017
19089,R,3127,1772,40,4939,1,0.6331241141931565
19091,R,3819,1442,50,5311,1,0.7190736207870457
19093,R,2880,917,44,3841,1,0.7498047383493882
19095,R,6009,3547,132,9688,1,0.6202518579686209
19097,R,6940,4029,111,11080,1,0.6263537906137184
19099,R,12084,7737,280,20101,1,0.6011641211880006
19101,R,4443,4319,139,8901,1,0.49915739804516346
19103,R,22925,59177,1276,83378,1,0.2749526253927895
19105,R,6572,4213,153,10938,1,0.6008411044066557
19107,R,3797,1414,67,5278,1,0.7194012883668056
19109,R,6275,2696,87,9058,1,0.6927577831750938
19111,R,9773,6541,338,16652,1,0.5868964688926255
19113,R,53364,70874,2527,126765,1,0.42096793278901906
19115,R,3500,1726,85,5311,1,0.6590096027113538
19117,R,3287,1284,44,4615,1,0.7122426868905742
19119,R,5707,1067,66,6840,1,0.8343567251461989
19121,R,6507,3134,149,9790,1,0.6646578140960163
19123,R,8297,2894,163,11354,1,0.7307556808173331
19125,R,12663,6178,292,19133,1,0.661840798620185
19127,R,9571,8176,284,18031,1,0.5308080527979591
19129,R,5585,2508,121,8214,1,0.679936693450207
19131,R,3677,2053,75,5805,1,0.6334194659776056
19133,R,3248,1407,47,4702,1,0.6907698851552531
19135,R,2975,1078,25,4078,1,0.7295242766061795
19137,R,3659,1583,68,5310,1,0.6890772128060264
19139,R,10823,9372,388,20583,1,0.5258222805227615
19141,R,5861,1569,96,7526,1,0.7787669412702631
19143,R,2690,601,25,3316,1,0.8112183353437877
19145,R,5319,2086,94,7499,1,0.7092945726096813
19147,R,3370,1519,55,4944,1,0.6816343042071198
19149,R,10492,3494,142,14128,1,0.742638731596829
19151,R,2826,933,51,3810,1,0.7417322834645669
19153,R,106800,146250,4166,257216,1,0.41521522766857427
19155,R,26247,18575,722,45544,1,0.5762998419111189
19157,R,5657,4306,142,10105,1,0.5598218703612073
19159,R,1968,709,26,2703,1,0.7280799112097669
19161,R,4061,1389,65,5515,1,0.7363553943789665
19163,R,43683,46926,1483,92092,1,0.47434087651478957
19165,R,4697,1959,110,6766,1,0.694206325746379
19167,R,15680,3019,221,18920,1,0.828752642706131
19169,R,20340,29175,1153,50668,1,0.4014368042946238
19171,R,5303,3577,122,9002,1,0.5890913130415463
19173,R,2463,746,21,3230,1,0.7625386996904024
19175,R,4010,2061,83,6154,1,0.6516087097822555
19177,R,2859,875,37,3771,1,0.7581543357199682
19179,R,9516,5821,244,15581,1,0.6107438546948206
19181,R,17782,12574,523,30879,1,0.5758606172479679
19183,R,6971,4561,183,11715,1,0.595049082373026
19185,R,2338,727,30,3095,1,0.7554119547657512
19187,R,10938,6613,173,17724,1,0.6171293161814488
19189,R,3707,2135,91,5933,1,0.6248103826057644
19191,R,6235,5617,159,12011,1,0.5191074848055949
19193,R,25736,18704,615,45055,1,0.5712129619354123
19195,R,2738,1596,58,4392,1,0.6234061930783242
19197,R,4136,1996,86,6218,1,0.665165648118366
20001,R,4218,1570,104,5892,1,0.7158859470468432
20003,R,2929,782,81,3792,1,0.772415611814346
20005,R,4906,2359,175,7440,1,0.6594086021505376
20007,R,2014,291,37,2342,1,0.8599487617421008
20009,R,8608,2340,182,11130,1,0.7734052111410602
20011,R,5023,1541,112,6676,1,0.7523966446974236
20013,R,3262,1104,105,4471,1,0.7295906955938268
20015,R,22634,9181,705,32520,1,0.6960024600246002
20017,R,1123,345,23,1491,1,0.7531857813547954
20019,R,1402,212,25,1639,1,0.8553996339231239
20021,R,6766,2194,168,9128,1,0.7412357581069238
20023,R,1183,224,22,1429,1,0.827851644506648
20025,R,904,143,20,1067,1,0.8472352389878163
20027,R,3177,894,111,4182,1,0.7596843615494978
20029,R,3242,920,101,4263,1,0.7604973023692235
20031,R,3489,964,112,4565,1,0.7642935377875137
20033,R,762,126,28,916,1,0.8318777292576419
20035,R,9656,4273,302,14231,1,0.6785187267233505
20037,R,10045,6179,421,16645,1,0.6034845298888555
20039,R,1260,218,20,1498,1,0.8411214953271028
20041,R,7126,2060,163,9349,1,0.7622205583484865
20043,R,2976,686,47,3709,1,0.8023726071717444
20045,R,17286,40785,1424,59495,1,0.29054542398520883
20047,R,1141,271,19,1431,1,0.7973445143256463
20049,R,1140,195,26,1361,1,0.8376193975018369
20051,R,9758,3737,305,13800,1,0.7071014492753623
20053,R,2148,648,57,2853,1,0.7528916929547844
20055,R,7236,4325,239,11800,1,0.6132203389830508
20057,R,5803,2947,165,8915,1,0.6509254066180594
20059,R,8479,3690,308,12477,1,0.6795704095535786
20061,R,5323,3983,297,9603,1,0.5543059460585233
20063,R,1291,166,14,1471,1,0.8776342624065262
20065,R,1080,228,29,1337,1,0.8077786088257293
20067,R,1936,518,47,2501,1,0.7740903638544582
20069,R,1911,341,36,2288,1,0.8352272727272727
20071,R,549,78,14,641,1,0.8564742589703588
20073,R,2444,569,64,3077,1,0.7942801429964251
20075,R,698,141,20,859,1,0.8125727590221188
20077,R,2168,461,49,2678,1,0.8095593726661687
20079,R,10182,6747,380,17309,1,0.588248887861806
20081,R,1122,268,20,1410,1,0.7957446808510639
20083,R,875,154,16,1045,1,0.8373205741626795
20085,R,4517,1881,186,6584,1,0.6860571081409478
20087,R,6334,3194,254,9782,1,0.6475158454303823
20089,R,1387,212,29,1628,1,0.851965601965602
20091,R,155631,184259,7324,347214,1,0.4482278940365308
20093,R,1164,267,24,1455,1,0.8
20095,R,3130,752,67,3949,1,0.7926057229678399
20097,R,980,156,29,1165,1,0.8412017167381974
20099,R,5735,2655,173,8563,1,0.6697419128809996
20101,R,762,115,18,895,1,0.8513966480446927
20103,R,21610,13886,994,36490,1,0.5922170457659632
20105,R,1283,266,30,1579,1,0.8125395820139328
20107,R,4048,896,102,5046,1,0.8022195798652398
20109,R,1249,186,23,1458,1,0.8566529492455418
20111,R,7550,6055,383,13988,1,0.5397483557334859
20113,R,9964,4134,340,14438,1,0.6901232857736529
20115,R,4465,1516,130,6111,1,0.7306496481754213
20117,R,3729,1259,126,5114,1,0.7291748142354322
20119,R,1523,263,39,1825,1,0.8345205479452055
20121,R,12308,5247,382,17937,1,0.6861794056977198
20123,R,2504,558,39,3101,1,0.8074814575943244
20125,R,9931,3228,267,13426,1,0.7396841948458215
20127,R,2124,729,46,2899,1,0.7326664367023111
20129,R,1034,150,14,1198,1,0.8631051752921536
20131,R,4664,927,93,5684,1,0.8205489092188599
20133,R,4970,1796,111,6877,1,0.7226988512432747
20135,R,1339,149,25,1513,1,0.8849966953073364
20137,R,2007,364,44,2415,1,0.831055900621118
20139,R,5705,2136,194,8035,1,0.7100186683260734
20141,R,1629,281,35,1945,1,0.8375321336760926
20143,R,2610,506,75,3191,1,0.8179254152303354
20145,R,2045,643,51,2739,1,0.74662285505659
20147,R,2418,318,45,2781,1,0.8694714131607335
20149,R,9452,3313,318,13083,1,0.7224642666055187
20151,R,3108,933,96,4137,1,0.751269035532995
20153,R,1261,214,29,1504,1,0.8384308510638298
20155,R,18443,8886,612,27941,1,0.6600694320174654
20157,R,2182,424,51,2657,1,0.8212269476853594
20159,R,3262,965,92,4319,1,0.7552674230145867
20161,R,11610,12765,796,25171,1,0.4612450836279846
20163,R,2325,339,35,2699,1,0.861430159318266
20165,R,1350,295,32,1677,1,0.8050089445438283
20167,R,2790,600,77,3467,1,0.8047303143928468
20169,R,15722,8214,595,24531,1,0.6409033467856997
20171,R,2014,299,41,2354,1,0.8555649957519117
20173,R,122416,95870,5402,223688,1,0.5472622581452737
20175,R,3372,1833,89,5294,1,0.6369474877219494
20177,R,40443,43015,2199,85657,1,0.472150553953559
20179,R,1282,147,16,1445,1,0.8871972318339101
20181,R,2269,396,62,2727,1,0.832049871653832
20183,R,1763,336,30,2129,1,0.828088304368248
20185,R,1645,357,32,2034,1,0.8087512291052114
20187,R,614,148,14,776,1,0.7912371134020618
20189,R,1760,237,34,2031,1,0.8665681930083703
20191,R,8105,2591,232,10928,1,0.7416727672035139
20193,R,3130,625,55,3810,1,0.821522309711286
20195,R,1363,242,25,1630,1,0.8361963190184049
20197,R,2845,964,93,3902,1,0.7291132752434649
20199,R,770,44,11,825,1,0.9333333333333333
20201,R,2363,475,45,2883,1,0.8196323274366979
20203,R,808,149,11,968,1,0.8347107438016529
20205,R,3153,723,78,3954,1,0.7974203338391502
20207,R,1228,294,24,1546,1,0.7943078913324709
20209,R,18934,36788,1063,56785,1,0.33343312494496785
21001,R,7276,1392,70,8738,1,0.8326848249027238
21003,R,7587,1642,113,9342,1,0.8121387283236994
21005,R,9661,3348,203,13212,1,0.7312291855888586
21007,R,3356,825,34,4215,1,0.7962040332147093
21009,R,14654,5127,222,20003,1,0.7325901114832775
21011,R,3986,1573,56,5615,1,0.7098842386464826
21013,R,8140,1789,85,10014,1,0.8128619932095067
21015,R,44814,20901,1074,66789,1,0.6709787539864349
21017,R,6190,3296,126,9612,1,0.643986683312526
21019,R,14295,7083,308,21686,1,0.6591810384579914
21021,R,8872,5298,234,14404,1,0.6159400166620383
21023,R,3398,800,35,4233,1,0.8027403732577368
21025,R,4265,1301,64,5630,1,0.7575488454706927
21027,R,7701,2350,122,10173,1,0.7570038336773813
21029,R,30708,10552,618,41878,1,0.7332728401547352
21031,R,4960,1079,71,6110,1,0.8117839607201309
21033,R,4906,1433,67,6406,1,0.7658445207617858
21035,R,11352,5797,254,17403,1,0.6523013273573521
21037,R,28482,19374,845,48701,1,0.5848339869817868
21039,R,2159,463,15,2637,1,0.8187334091770951
21041,R,2954,1116,52,4122,1,0.7166424065987385
21043,R,8775,2642,123,11540,1,0.7603986135181976
21045,R,6179,918,62,7159,1,0.8631093728174326
21047,R,15080,8296,392,23768,1,0.6344665095927298
21049,R,11811,6004,260,18075,1,0.6534439834024897
21051,R,6677,831,59,7567,1,0.882384035945553
21053,R,4280,603,39,4922,1,0.8695652173913043
21055,R,3451,731,53,4235,1,0.8148760330578513
21057,R,2769,508,25,3302,1,0.8385826771653543
21059,R,31025,17286,766,49077,1,0.6321698555331418
21061,R,4828,1227,66,6121,1,0.7887600065348799
21063,R,2246,712,27,2985,1,0.752428810720268
21065,R,5100,1355,67,6522,1,0.7819687212511499
21067,R,58860,90600,2692,152152,1,0.38684999211315
21069,R,5534,1474,42,7050,1,0.7849645390070922
21071,R,12250,3884,148,16282,1,0.7523645743766122
21073,R,12900,12652,420,25972,1,0.4966887417218543
21075,R,1606,794,20,2420,1,0.6636363636363637
21077,R,2955,822,61,3838,1,0.7699322563835331
21079,R,6754,1830,94,8678,1,0.7782899285549666
21081,R,8725,2205,156,11086,1,0.7870286848277106
21083,R,13206,3560,217,16983,1,0.7776011305423071
21085,R,9453,2400,97,11950,1,0.7910460251046025
21087,R,4838,920,36,5794,1,0.835001725923369
21089,R,13064,4873,206,18143,1,0.7200573223832883
21091,R,3145,1351,77,4573,1,0.6877323420074349
21093,R,29832,18101,857,48790,1,0.6114367698298832
21095,R,9367,1494,94,10955,1,0.8550433591967138
21097,R,6334,2400,99,8833,1,0.717083663534473
21099,R,6345,1908,94,8347,1,0.7601533485084462
21101,R,12730,7639,269,20638,1,0.6168233355945344
21103,R,5843,2142,103,8088,1,0.7224282888229476
21105,R,1714,458,23,2195,1,0.780865603644647
21107,R,15757,5439,250,21446,1,0.7347290870092325
21109,R,5453,605,40,6098,1,0.894227615611676
21111,R,150646,228358,5531,384535,1,0.39176147814893314
21113,R,17096,8567,496,26159,1,0.6535418020566536
21115,R,8450,1608,103,10161,1,0.831611061903356
21117,R,48129,32271,1495,81895,1,0.587691556261066
21119,R,4780,1412,43,6235,1,0.7666399358460305
21121,R,11012,2114,115,13241,1,0.8316592402386527
21123,R,5685,1504,93,7282,1,0.7806921175501236
21125,R,23237,4475,334,28046,1,0.8285316979248377
21127,R,5633,1238,64,6935,1,0.8122566690699351
21129,R,2273,481,35,2789,1,0.8149874506991753
21131,R,4321,446,32,4799,1,0.9003959158157949
21133,R,7226,1799,82,9107,1,0.7934555836169979
21135,R,4986,823,67,5876,1,0.8485364193328795
21137,R,8489,2254,147,10890,1,0.7795224977043159
21139,R,4010,939,48,4997,1,0.802481488893336
21141,R,9067,3094,163,12324,1,0.7357189224277831
21143,R,3100,1092,29,4221,1,0.7344231224828239
21145,R,21820,11195,419,33434,1,0.652629060238081
21147,R,5664,725,38,6427,1,0.8812820911778435
21149,R,3633,1074,64,4771,1,0.7614755816390694
21151,R,27356,15581,834,43771,1,0.6249800095953942
21153,R,4174,1214,49,5437,1,0.7677027772668751
21155,R,6113,2722,69,8904,1,0.6865453728661276
21157,R,13297,4071,189,17557,1,0.7573617360596913
21159,R,3496,403,23,3922,1,0.8913819479857216
21161,R,5477,2362,100,7939,1,0.6898853759919386
21163,R,10185,3632,261,14078,1,0.7234692427901691
21165,R,2311,750,29,3090,1,0.7478964401294499
21167,R,8506,3033,156,11695,1,0.7273193672509619
21169,R,3959,975,66,5000,1,0.7918
21171,R,4628,657,35,5320,1,0.8699248120300752
21173,R,8993,3630,173,12796,1,0.7027977492966552
21175,R,4301,1175,45,5521,1,0.7790255388516573
21177,R,10497,3545,155,14197,1,0.7393815594843981
21179,R,15703,7188,309,23200,1,0.676853448275862
21181,R,2408,955,30,3393,1,0.7096964338343649
21183,R,8582,2404,112,11098,1,0.7732924851324563
21185,R,22654,14505,668,37827,1,0.5988843947444946
21187,R,4292,1098,56,5446,1,0.7881013587954462
21189,R,1671,216,6,1893,1,0.8827258320126783
21191,R,5515,1322,70,6907,1,0.7984653250325756
21193,R,8129,2356,112,10597,1,0.7671038973294328
21195,R,20284,4866,180,25330,1,0.8007895775759969
21197,R,4041,1367,81,5489,1,0.7361996720714156
21199,R,25442,5666,354,31462,1,0.8086580636958871
21201,R,884,253,7,1144,1,0.7727272727272727
21203,R,6577,1134,59,7770,1,0.8464607464607464
21205,R,5994,3880,153,10027,1,0.5977859778597786
21207,R,7519,1331,93,8943,1,0.840769316784077
21209,R,17767,10567,532,28866,1,0.6154992032148549
21211,R,15055,8077,340,23472,1,0.6414025221540559
21213,R,5888,2681,145,8714,1,0.6756942850585265
21215,R,8737,2530,141,11408,1,0.7658660589060309
21217,R,9376,2963,138,12477,1,0.7514626913520879
21219,R,4062,1205,72,5339,1,0.7608166323281513
21221,R,5487,1791,83,7361,1,0.7454150251324548
21223,R,3227,1012,70,4309,1,0.7488976560686934
21225,R,4965,1529,73,6567,1,0.7560529922338968
21227,R,31791,22479,900,55170,1,0.5762370853724851
21229,R,4482,1644,83,6209,1,0.7218553712353036
21231,R,7430,1700,81,9211,1,0.8066442297253285
21233,R,4506,1412,57,5975,1,0.754142259414226
21235,R,12567,2552,194,15313,1,0.8206752432573631
21237,R,2097,839,30,2966,1,0.7070128118678355
21239,R,8362,6530,269,15161,1,0.551546731745927
22001,R,22596,5443,268,28307,1,0.7982477832338291
22003,R,7574,2108,80,9762,1,0.7758656013112067
22005,R,40687,20399,865,61951,1,0.6567609885231876
22007,R,7271,3833,82,11186,1,0.6500089397461112
22009,R,12028,4979,173,17180,1,0.70011641443539
22011,R,13575,2542,181,16298,1,0.8329242851883667
22013,R,3891,3067,55,7013,1,0.5548267503208327
22015,R,38074,15662,684,54420,1,0.6996324880558619
22017,R,48021,55110,1123,104254,1,0.4606154200318453
22019,R,55066,25982,1162,82210,1,0.6698211896362973
22021,R,3976,745,26,4747,1,0.8375816305034759
22023,R,3671,324,25,4020,1,0.91318407960199
22025,R,3541,1269,27,4837,1,0.732065329749845
22027,R,3770,2731,34,6535,1,0.576893649579189
22029,R,5550,3177,71,8798,1,0.6308251875426233
22031,R,9112,5457,86,14655,1,0.6217673149095871
22033,R,88420,115577,2645,206642,1,0.4278897803931437
22035,R,1080,1900,23,3003,1,0.3596403596403596
22037,R,6064,4280,107,10451,1,0.580231556788824
22039,R,11053,4158,110,15321,1,0.7214281052150643
22041,R,6970,2658,49,9677,1,0.7202645447969412
22043,R,8117,1157,87,9361,1,0.8671082149343019
22045,R,21251,11027,273,32551,1,0.6528524469294338
22047,R,7893,8514,157,16564,1,0.4765153344602753
22049,R,5394,2143,56,7593,1,0.7103911497431845
22051,R,105949,84477,2129,192555,1,0.5502272078107554
22053,R,11423,3208,143,14774,1,0.773182618112901
22055,R,72519,39685,1609,113813,1,0.6371767724249426
22057,R,36024,8672,471,45167,1,0.797573449642438
22059,R,6378,638,44,7060,1,0.9033994334277621
22061,R,11311,7559,292,19162,1,0.5902828514768813
22063,R,54877,9249,865,64991,1,0.8443784524011017
22065,R,1930,2654,34,4618,1,0.4179298397574708
22067,R,6510,4946,68,11524,1,0.5649080180492885
22069,R,9358,6896,193,16447,1,0.568979145132851
22071,R,26664,147854,1734,176252,1,0.15128338969203187
22073,R,42255,25913,671,68839,1,0.6138235593195718
22075,R,7412,3414,111,10937,1,0.677699551979519
22077,R,7503,4683,112,12298,1,0.6100992031224589
22079,R,38347,19475,747,58569,1,0.6547320254742269
22081,R,2413,1644,37,4094,1,0.5893991206643869
22083,R,6607,3225,61,9893,1,0.6678459516830082
22085,R,8776,1731,56,10563,1,0.8308245763514153
22087,R,11179,6151,207,17537,1,0.6374522438273365
22089,R,18233,9800,322,28355,1,0.6430259213542585
22091,R,2714,3346,53,6113,1,0.44397186324227056
22093,R,5954,6510,61,12525,1,0.4753692614770459
22095,R,7538,13582,138,21258,1,0.3545959168313106
22097,R,23171,17372,350,40893,1,0.5666250947594943
22099,R,18203,8439,234,26876,1,0.6772957285310314
22101,R,14811,8055,186,23052,1,0.6425039042165539
22103,R,99666,37746,2009,139421,1,0.7148564419994119
22105,R,37806,18887,632,57325,1,0.659502834714348
22107,R,1197,1329,13,2539,1,0.47144545096494683
22109,R,34339,11198,471,46008,1,0.7463701964875674
22111,R,8407,2654,86,11147,1,0.7541939535300978
22113,R,21930,5009,250,27189,1,0.8065761888999228
22115,R,14107,2898,205,17210,1,0.8196978500871587
22117,R,13307,5970,132,19409,1,0.6856097686640218
22119,R,11830,6172,138,18140,1,0.6521499448732084
22121,R,7684,6200,130,14014,1,0.5483088340231197
22123,R,4317,710,12,5039,1,0.8567176026989483
22125,R,3863,2298,72,6233,1,0.61976576287502
22127,R,4619,1543,43,6205,1,0.7443996776792909
23001,D,29268,27617,1816,58701,0,0.49859457249450606
23003,D,21080,13956,706,35742,0,0.5897823289127637
23005,D,60422,133358,5674,199454,0,0.3029370180593019
23007,D,8754,8069,567,17390,0,0.5033927544565843
23009,D,14980,19366,970,35316,0,0.4241703477177483
23011,D,34721,34902,2227,71850,0,0.4832428670842032
23013,D,9982,15110,637,25729,0,0.3879668856154534
23015,D,10256,12684,654,23594,0,0.4346867847757905
23017,D,17698,14755,1038,33491,0,0.5284404765459377
23019,D,44827,37716,2725,85268,0,0.5257189097903082
23021,D,6143,3517,245,9905,0,0.6201918223119637
23023,D,9755,13528,753,24036,0,0.4058495589948411
23025,D,16644,10199,728,27571,0,0.6036777773747778
23027,D,11196,12345,780,24321,0,0.46034291353151596
23029,D,10194,6761,397,17352,0,0.5874827109266944
23031,D,54817,71189,3648,129654,0,0.42279451463124934
24001,D,20886,9158,467,30511,0,0.6845400019665039
24003,D,127821,172823,6280,306924,0,0.4164581459905384
24005,D,146202,258409,7295,411906,0,0.3549402048040087
24009,D,25346,22587,899,48832,0,0.5190448885976409
24011,D,10283,5095,351,15729,0,0.6537605696484201
24013,D,60218,36456,2734,99408,0,0.605766135522292
24015,D,29439,16809,1025,47273,0,0.6227444841664375
24017,D,25579,62171,1313,89063,0,0.2872011946599598
24019,D,8764,6857,313,15934,0,0.5500188276641145
24021,D,63682,77675,3211,144568,0,0.44049858889934146
24023,D,12002,3281,296,15579,0,0.7703960459593042
24025,D,80930,63095,3196,147221,0,0.5497177712418745
24027,D,48390,129433,3501,181324,0,0.26687035362114225
24029,D,5195,5329,216,10740,0,0.48370577281191807
24031,D,101222,419569,8778,529569,0,0.19114034242940958
24033,D,37090,379208,6553,422851,0,0.08771411206311443
24035,D,18741,10709,629,30079,0,0.6230592772366103
24037,D,30826,23138,1375,55339,0,0.5570393393447659
24039,D,5739,4241,137,10117,0,0.5672630226351685
24041,D,10946,11062,392,22400,0,0.4886607142857143
24043,D,40224,26044,1242,67510,0,0.5958228410605836
24045,D,22944,22054,977,45975,0,0.4990538336052202
24047,D,18571,12560,436,31567,0,0.5883042417714702
24510,D,25374,207260,3555,236189,0,0.10743091337869248
25001,D,55311,91994,2494,149799,0,0.3692347745979613
25003,D,18064,51705,1392,71161,0,0.2538469105268335
25005,D,119872,153377,5094,278343,0,0.4306628871572125
25007,D,2631,9914,220,12765,0,0.20611045828437133
25009,D,144837,267198,7255,419290,0,0.3454339478642467
25011,D,11201,30030,1072,42303,0,0.26478027563056994
25013,D,87318,125948,4137,217403,0,0.40164119170388635
25015,D,22281,63362,1854,87497,0,0.2546487308136279
25017,D,226956,617196,15133,859285,0,0.2641219153133128
25019,D,1914,5241,122,7277,0,0.263020475470661
25021,D,125294,273312,6944,405550,0,0.30894834175810626
25023,D,121227,173630,5634,300491,0,0.4034297200248926
25025,D,58613,270522,4654,333789,0,0.1755989562268379
25027,D,171683,248773,9666,430122,0,0.39914954361785726
26001,D,4848,2142,73,7063,0,0.6863938836188589
26003,D,3014,2053,61,5128,0,0.5877535101404057
26005,D,41392,24449,1241,67082,0,0.6170358665513849
26007,D,10686,6000,280,16966,0,0.6298479311564306
26009,D,9748,5960,241,15949,0,0.6111981942441532
26011,D,5928,2774,129,8831,0,0.6712716566640244
26013,D,2512,1478,46,4036,0,0.622398414271556
26015,D,23471,11797,637,35905,0,0.6536972566494917
26017,D,33125,26151,977,60253,0,0.5497651569216471
26019,D,6601,5480,179,12260,0,0.5384176182707994
26021,D,43519,37438,1422,82379,0,0.528277837798468
26023,D,14064,6159,313,20536,0,0.6848461238800155
26025,D,36221,28877,1178,66276,0,0.5465175930955398
26027,D,16699,9130,384,26213,0,0.6370503185442338
26029,D,9841,6939,220,17000,0,0.5788823529411765
26031,D,10186,5437,245,15868,0,0.6419208469876481
26033,D,10681,6648,311,17640,0,0.605498866213152
26035,D,10861,5199,221,16281,0,0.6670966156869971
26037,D,25098,21968,844,47910,0,0.5238572323105823
26039,D,5087,2672,102,7861,0,0.6471186871899249
26041,D,13207,7606,338,21151,0,0.6244149212803177
26043,D,9617,4744,228,14589,0,0.6591952841181712
26045,D,31798,31299,1207,64304,0,0.49449489922866385
26047,D,12135,9662,379,22176,0,0.5472132034632035
26049,D,98714,119390,3212,221316,0,0.44603191816226573
26051,D,9893,4524,186,14603,0,0.677463534890091
26053,D,4600,3570,96,8266,0,0.5564964916525527
26055,D,30502,28683,1042,60227,0,0.5064505952479785
26057,D,12102,6693,331,19126,0,0.6327512286939245
26059,D,17037,5883,368,23288,0,0.7315784953624184
26061,D,10378,7750,373,18501,0,0.5609426517485542
26063,D,12731,5490,216,18437,0,0.6905136410478928
26065,D,47639,94212,2654,144505,0,0.3296702536244421
26067,D,20657,10901,647,32205,0,0.6414221394193448
26069,D,9759,5373,227,15359,0,0.6353929292271632
26071,D,4216,2493,80,6789,0,0.6210045662100456
26073,D,14815,14072,522,29409,0,0.5037573531912
26075,D,47372,31995,1478,80845,0,0.5859607891644505
26077,D,56823,83686,2867,143376,0,0.39632156009373953
26079,D,7436,3002,192,10630,0,0.6995296331138288
26081,D,165741,187915,7183,360839,0,0.45932119310828373
26083,D,862,672,23,1557,0,0.5536287732819525
26085,D,3946,2288,89,6323,0,0.6240708524434604
26087,D,35482,16367,791,52640,0,0.6740501519756839
26089,D,7916,8795,187,16898,0,0.46845780565747425
26091,D,31541,20918,915,53374,0,0.5909431558436692
26093,D,76982,48220,1964,127166,0,0.6053662142396553
26095,D,2109,842,50,3001,0,0.7027657447517495
26097,D,4304,2632,79,7015,0,0.6135424091233072
26099,D,263863,223952,6404,494219,0,0.5338989395389493
26101,D,8321,6107,226,14654,0,0.5678313088576498
26103,D,16286,20465,707,37458,0,0.434780287255059
26105,D,10207,6802,240,17249,0,0.5917444489535625
26107,D,13267,7375,404,21046,0,0.6303810700370617
26109,D,8117,4316,173,12606,0,0.6438997302871649
26111,D,27675,20493,905,49073,0,0.5639557394086361
26113,D,6648,1967,139,8754,0,0.7594242631939685
26115,D,52710,32975,1463,87148,0,0.6048331573874328
26117,D,21815,9703,568,32086,0,0.6798915414822664
26119,D,4171,1628,60,5859,0,0.7118962280252603
26121,D,45133,45643,1659,92435,0,0.48826743116784765
26123,D,18857,7873,426,27156,0,0.6943953454116953
26125,D,325971,434148,10090,770209,0,0.42322408592992294
26127,D,8892,4944,226,14062,0,0.6323424832882947
26129,D,8253,3475,179,11907,0,0.6931216931216931
26131,D,2358,1391,55,3804,0,0.6198738170347003
26133,D,8928,3214,187,12329,0,0.7241463216805905
26135,D,3466,1342,66,4874,0,0.7111202297907263
26137,D,9779,4743,234,14756,0,0.6627134724857685
26139,D,100913,64705,3009,168627,0,0.5984391586163544
26141,D,5342,2911,89,8342,0,0.6403740110285303
26143,D,9670,5166,182,15018,0,0.6438939938740178
26145,D,50785,51088,1474,103347,0,0.4914027499588764
26147,D,59185,31363,1515,92063,0,0.6428749877801071
26149,D,18127,9262,546,27935,0,0.648899230356184
26151,D,16194,5966,286,22446,0,0.7214648489708634
26153,D,3090,1589,66,4745,0,0.6512118018967334
26155,D,23149,15347,724,39220,0,0.5902345741968383
26157,D,20297,8712,433,29442,0,0.6893893077915902
26159,D,21591,16803,669,39063,0,0.5527225251516781
26161,D,56241,157136,2903,216280,0,0.26003791381542446
26163,D,264553,597170,10660,872383,0,0.3032532729317284
26165,D,12102,5838,325,18265,0,0.6625787024363536
27001,D,6258,3607,103,9968,0,0.6278089887640449
27003,D,104902,100893,3650,209445,0,0.5008570269044379
27005,D,12438,6589,234,19261,0,0.6457608639219148
27007,D,12188,11426,373,23987,0,0.5081085588026848
27009,D,14382,7280,477,22139,0,0.6496228375265369
27011,D,1863,1053,36,2952,0,0.6310975609756098
27013,D,16731,18330,708,35769,0,0.4677514048477732
27015,D,9552,4753,210,14515,0,0.6580778504994833
27017,D,9791,10098,336,20225,0,0.48410383189122375
27019,D,34009,30774,1075,65858,0,0.5163989188860882
27021,D,11620,6342,201,18163,0,0.6397621538292132
27023,D,4250,2226,91,6567,0,0.6471752702908482
27025,D,21916,11806,629,34351,0,0.6380018048965096
27027,D,15043,16357,574,31974,0,0.4704760117595546
27029,D,3372,1260,50,4682,0,0.7202050405809484
27031,D,1203,2496,62,3761,0,0.3198617388992289
27033,D,4165,1834,78,6077,0,0.6853710712522626
27035,D,25676,13726,520,39922,0,0.6431541505936577
27037,D,109638,146155,4271,260064,0,0.4215808416389812
27039,D,7783,4079,235,12097,0,0.643382656857072
27041,D,15799,7868,351,24018,0,0.6577983179282205
27043,D,5191,2531,116,7838,0,0.6622862975248788
27045,D,7301,4551,178,12030,0,0.6068994181213633
27047,D,9578,6889,227,16694,0,0.5737390679285971
27049,D,16052,11806,571,28429,0,0.5646347039994372
27051,D,2269,1300,62,3631,0,0.6248967226659322
27053,D,205973,532623,11163,749759,0,0.2747189430203572
27055,D,6334,4853,176,11363,0,0.5574232157000792
27057,D,8202,4462,208,12872,0,0.637197016780609
27059,D,16491,7138,422,24051,0,0.685667955594362
27061,D,15239,10786,376,26401,0,0.5772129843566531
27063,D,3948,1745,84,5777,0,0.683399688419595
27065,D,6278,2774,134,9186,0,0.6834313085129545
27067,D,14437,8440,318,23195,0,0.6224186247035999
27069,D,1546,1006,59,2611,0,0.5921103025660667
27071,D,4131,2659,87,6877,0,0.6006979787698125
27073,D,2528,1446,40,4014,0,0.6297957149975087
27075,D,3393,3647,115,7155,0,0.4742138364779874
27077,D,1704,671,26,2401,0,0.709704289879217
27079,D,10775,5672,248,16695,0,0.645402815214136
27081,D,2121,937,36,3094,0,0.6855203619909502
27083,D,7979,4634,192,12805,0,0.6231159703240922
27085,D,13986,6413,392,20791,0,0.6726949160694531
27087,D,1142,1112,22,2276,0,0.5017574692442882
27089,D,3721,1295,56,5072,0,0.7336356466876972
27091,D,7480,3305,144,10929,0,0.6844176045383841
27093,D,9359,3867,194,13420,0,0.6973919523099851
27095,D,9952,4404,241,14597,0,0.6817839282044256
27097,D,14821,4367,256,19444,0,0.7622402797778235
27099,D,10025,8899,270,19194,0,0.5222986349901011
27101,D,3363,1449,52,4864,0,0.69140625
27103,D,9018,9622,344,18984,0,0.475031605562579
27105,D,5600,2933,99,8632,0,0.6487488415199258
27107,D,1953,1404,47,3404,0,0.5737367802585194
27109,D,39692,49491,1540,90723,0,0.437507578012191
27111,D,23800,11958,409,36167,0,0.6580584510741837
27113,D,4532,2568,134,7234,0,0.6264860381531656
27115,D,10256,5419,243,15918,0,0.6443020479959793
27117,D,3553,1306,46,4905,0,0.7243628950050969
27119,D,9865,5439,192,15496,0,0.6366159008776459
27121,D,4417,2477,85,6979,0,0.6328986960882648
27123,D,77376,211620,4443,293439,0,0.26368683099383516
27125,D,1454,691,30,2175,0,0.6685057471264367
27127,D,5771,2355,105,8231,0,0.7011298748633216
27129,D,5467,2496,111,8074,0,0.6771117166212534
27131,D,17464,17402,572,35438,0,0.49280433433037985
27133,D,3583,1556,58,5197,0,0.689436213199923
27135,D,6065,2188,116,8369,0,0.7246982913131796
27137,D,49017,67704,1961,118682,0,0.41301124012065854
27139,D,45872,40040,1459,87371,0,0.5250254661157593
27141,D,36222,18065,982,55269,0,0.6553764316343701
27143,D,5864,2417,110,8391,0,0.6988439995232988
27145,D,50959,31879,1481,84319,0,0.6043596342461367
27147,D,12656,7917,389,20962,0,0.6037591832840378
27149,D,3044,1922,74,5040,0,0.6039682539682539
27151,D,3316,1784,62,5162,0,0.642386671832623
27153,D,9753,3286,139,13178,0,0.7400971315829412
27155,D,1172,661,19,1852,0,0.6328293736501079
27157,D,8153,4696,196,13045,0,0.6249904177845917
27159,D,5520,2023,80,7623,0,0.7241243604879969
27161,D,6624,3496,184,10304,0,0.6428571428571429
27163,D,73764,89165,2673,165602,0,0.4454294030265335
27165,D,3103,1987,60,5150,0,0.6025242718446602
27167,D,2328,1026,57,3411,0,0.6824978012313104
27169,D,13227,13333,407,26967,0,0.49048837468016465
27171,D,51973,28430,1446,81849,0,0.6349863773534191
27173,D,3734,1688,66,5488,0,0.6803935860058309
28001,R,5696,7917,67,13680,1,0.41637426900584795
28003,R,12818,2782,138,15738,1,0.8144618121743551
28005,R,4503,2620,39,7162,1,0.6287349902261938
28007,R,5178,3542,59,8779,1,0.5898166078141018
28009,R,2570,1679,23,4272,1,0.6015917602996255
28011,R,4671,8904,77,13652,1,0.34214767067096397
28013,R,4625,1902,27,6554,1,0.7056759231003967
28015,R,3924,1729,25,5678,1,0.6910884114124691
28017,R,4175,3810,94,8079,1,0.5167718777076371
28019,R,3001,1185,22,4208,1,0.7131653992395437
28021,R,603,3772,34,4409,1,0.13676570650941255
28023,R,5417,2838,50,8305,1,0.6522576760987358
28025,R,4181,5844,85,10110,1,0.4135509396636993
28027,R,2375,6020,47,8442,1,0.28133143804785593
28029,R,6250,6470,88,12808,1,0.4879762648344784
28031,R,5854,3416,43,9313,1,0.6285837002040159
28033,R,46462,28265,979,75706,1,0.6137162180012152
28035,R,17290,13755,428,31473,1,0.5493597686906238
28037,R,2923,1480,34,4437,1,0.6587784539102998
28039,R,9713,1218,75,11006,1,0.8825186262038888
28041,R,4794,966,30,5790,1,0.827979274611399
28043,R,6081,4734,56,10871,1,0.559378162082605
28045,R,16132,4504,237,20873,1,0.7728644660566282
28047,R,46822,27728,897,75447,1,0.6205945895794399
28049,R,25141,73550,652,99343,1,0.25307268755725115
28051,R,1369,6588,72,8029,1,0.17050691244239632
28053,R,1118,3016,24,4158,1,0.2688792688792689
28055,R,308,355,6,669,1,0.46038863976083705
28057,R,9438,1249,99,10786,1,0.8750231781939551
28059,R,36295,17375,636,54306,1,0.668342356277391
28061,R,4302,4341,48,8691,1,0.494994822229893
28063,R,531,3327,25,3883,1,0.13674993561679114
28065,R,2534,3599,32,6165,1,0.4110300081103001
28067,R,21226,8517,223,29966,1,0.7083361142628312
28069,R,1787,2887,30,4704,1,0.3798894557823129
28071,R,12949,10070,306,23325,1,0.5551554126473741
28073,R,20704,7340,327,28371,1,0.7297592612174404
28075,R,17967,12960,204,31131,1,0.5771417558061097
28077,R,4285,2260,33,6578,1,0.6514138035877166
28079,R,5228,3897,30,9155,1,0.5710540688148553
28081,R,24207,12189,378,36774,1,0.6582639908631098
28083,R,3129,7648,55,10832,1,0.28886632200886264
28085,R,11596,5040,105,16741,1,0.6926706887282719
28087,R,13800,13087,242,27129,1,0.5086807475395333
28089,R,31091,24440,443,55974,1,0.5554543180762497
28091,R,8273,3787,65,12125,1,0.6823092783505155
28093,R,7566,8057,97,15720,1,0.4812977099236641
28095,R,11177,5874,127,17178,1,0.6506578181394808
28097,R,2917,2121,17,5055,1,0.5770524233432245
28099,R,8320,3260,62,11642,1,0.7146538395464697
28101,R,6997,3075,67,10139,1,0.6901075056711707
28103,R,1240,4040,28,5308,1,0.23360964581763377
28105,R,9004,10299,337,19640,1,0.4584521384928717
28107,R,8060,7403,77,15540,1,0.5186615186615187
28109,R,19595,4148,217,23960,1,0.8178213689482471
28111,R,4500,1362,35,5897,1,0.763099881295574
28113,R,8479,8646,131,17256,1,0.49136532220676865
28115,R,11550,2614,135,14299,1,0.8077487936219316
28117,R,8370,2153,82,10605,1,0.7892503536067893
28119,R,1026,2150,27,3203,1,0.32032469559787696
28121,R,50895,18847,671,70413,1,0.722806868049934
28123,R,6285,4330,70,10685,1,0.5882077678989237
28125,R,688,1465,16,2169,1,0.3171968649147072
28127,R,7635,4037,85,11757,1,0.6494003572339883
28129,R,6458,1791,45,8294,1,0.7786351579455028
28131,R,5964,1802,73,7839,1,0.7608113279755071
28133,R,2799,6781,43,9623,1,0.2908656344175413
28135,R,2488,3105,47,5640,1,0.44113475177304967
28137,R,8707,4183,119,13009,1,0.6693058651702667
28139,R,8054,1937,61,10052,1,0.8012335853561481
28141,R,7933,1059,110,9102,1,0.8715666886398594
28143,R,926,2580,19,3525,1,0.26269503546099293
28145,R,10373,2160,103,12636,1,0.8209085153529598
28147,R,4220,2835,36,7091,1,0.5951205753772387
28149,R,10365,10442,150,20957,1,0.4945841484945364
28151,R,5300,12503,94,17897,1,0.29613901771246576
28153,R,6307,3624,68,9999,1,0.6307630763076307
28155,R,4291,1043,36,5370,1,0.7990689013035381
28157,R,1324,2749,32,4105,1,0.3225334957369062
28159,R,5112,4040,50,9202,1,0.55553140621604
28161,R,3671,2785,41,6497,1,0.5650300138525474
28163,R,4832,5496,50,10378,1,0.46560030834457505
29001,R,6413,3710,212,10335,1,0.6205128205128205
29003,R,7255,2351,146,9752,1,0.7439499589827727
29005,R,2199,564,51,2814,1,0.7814498933901919
29007,R,7732,2704,214,10650,1,0.7260093896713615
29009,R,12425,2948,225,15598,1,0.7965764841646364
29011,R,5168,844,65,6077,1,0.850419614941583
29013,R,6597,1672,147,8416,1,0.7838640684410646
29015,R,8109,2180,186,10475,1,0.7741288782816229
29017,R,5167,750,66,5983,1,0.863613571786729
29019,R,38646,50064,2420,91130,1,0.42407549654339954
29021,R,22450,13445,703,36598,1,0.6134214984425378
29023,R,14602,3301,237,18140,1,0.8049614112458655
29025,R,3725,897,60,4682,1,0.7956001708671507
29027,R,14815,5870,455,21140,1,0.7008041627246925
29029,R,18850,5652,310,24812,1,0.7597130420764147
29031,R,28907,10760,642,40309,1,0.7171351311121585
29033,R,3706,786,40,4532,1,0.8177405119152692
29035,R,2451,418,28,2897,1,0.8460476354849845
29037,R,37197,19052,1149,57398,1,0.6480539391616432
29039,R,5788,1145,110,7043,1,0.8218088882578447
29041,R,3111,916,49,4076,1,0.7632482826300294
29043,R,34920,11131,774,46825,1,0.7457554725040043
29045,R,2672,678,44,3394,1,0.7872716558632882
29047,R,64605,59400,2523,126528,1,0.51059844461305
29049,R,7799,2896,193,10888,1,0.7162931667891257
29051,R,26086,12694,734,39514,1,0.6601710786050514
29053,R,6272,2249,169,8690,1,0.7217491369390103
29055,R,8725,2113,135,10973,1,0.7951335095233756
29057,R,3414,656,49,4119,1,0.8288419519300801
29059,R,6619,1380,105,8104,1,0.8167571569595261
29061,R,3102,746,61,3909,1,0.7935533384497314
29063,R,3828,930,85,4843,1,0.7904191616766467
29065,R,5987,1056,99,7142,1,0.8382805936712405
29067,R,5898,1016,86,7000,1,0.8425714285714285
29069,R,8135,2200,84,10419,1,0.7807851041366733
29071,R,38058,14569,1050,53677,1,0.7090187603629114
29073,R,6222,1601,100,7923,1,0.7853085952290799
29075,R,2581,613,41,3235,1,0.7978361669242658
29077,R,83630,55068,3050,141748,1,0.5899906876992973
29079,R,3585,799,53,4437,1,0.8079783637592968
29081,R,3198,597,30,3825,1,0.836078431372549
29083,R,8027,2619,142,10788,1,0.7440674823878384
29085,R,3966,1056,58,5080,1,0.7807086614173229
29087,R,1976,338,29,2343,1,0.8433632095603927
29089,R,3553,1413,125,5091,1,0.6978982518169319
29091,R,15181,3218,249,18648,1,0.814081939081939
29093,R,3596,945,51,4592,1,0.7831010452961672
29095,R,126535,199842,6556,332933,1,0.380061453806021
29097,R,37728,13549,1069,52346,1,0.7207427501623811
29099,R,77046,37523,2103,116672,1,0.6603640976412507
29101,R,15489,6974,659,23122,1,0.6698814981402993
29103,R,1486,340,28,1854,1,0.8015102481121898
29105,R,13762,2780,250,16792,1,0.8195569318723201
29107,R,12273,4472,306,17051,1,0.7197818309776552
29109,R,14426,3214,265,17905,1,0.8056967327562133
29111,R,3553,984,72,4609,1,0.7708830548926014
29113,R,21848,6607,562,29017,1,0.7529379329358652
29115,R,4363,1275,83,5721,1,0.7626289110295403
29117,R,5267,1410,80,6757,1,0.7794879384342164
29119,R,7465,1439,148,9052,1,0.8246796288113124
29121,R,6076,1662,98,7836,1,0.7753956100051046
29123,R,4584,1019,73,5676,1,0.8076109936575053
29125,R,3892,814,65,4771,1,0.8157618947809684
29127,R,9915,3202,228,13345,1,0.7429748969651555
29129,R,1541,222,16,1779,1,0.8662169758291175
29131,R,10176,2038,166,12380,1,0.8219709208400646
29133,R,3537,1178,41,4756,1,0.7436921783010934
29135,R,5744,1308,105,7157,1,0.802570909598994
29137,R,3477,936,70,4483,1,0.775596698639304
29139,R,4465,1208,99,5772,1,0.7735620235620235
29141,R,7442,1924,121,9487,1,0.784441867819121
29143,R,5447,1748,53,7248,1,0.7515176600441501
29145,R,22120,5818,452,28390,1,0.779147587178584
29147,R,6865,2853,170,9888,1,0.6942758899676376
29149,R,3847,823,69,4739,1,0.8117746359991559
29151,R,6425,1037,77,7539,1,0.8522350444356015
29153,R,4064,752,48,4864,1,0.8355263157894737
29155,R,4120,1560,55,5735,1,0.7183958151700087
29157,R,7657,1664,126,9447,1,0.8105218587911507
29159,R,13854,4783,459,19096,1,0.7254922496857981
29161,R,13480,5637,440,19557,1,0.6892672700311909
29163,R,5863,1717,115,7695,1,0.7619233268356075
29165,R,28917,27179,1153,57249,1,0.5051092595503852
29167,R,11850,2885,327,15062,1,0.7867481078210065
29169,R,10329,3740,345,14414,1,0.7165949771055918
29171,R,1984,361,16,2361,1,0.8403218975010589
29173,R,4396,1205,61,5662,1,0.7764040974920523
29175,R,8018,2485,239,10742,1,0.7464159374418171
29177,R,8345,3109,195,11649,1,0.7163705039059147
29179,R,2733,529,36,3298,1,0.8286840509399637
29181,R,4839,833,45,5717,1,0.8464229490991779
29183,R,128389,89530,4073,221992,1,0.5783496702583877
29185,R,3932,988,54,4974,1,0.7905106554081223
29186,R,6630,2713,141,9484,1,0.6990721214677351
29187,R,20511,7044,446,28001,1,0.7325095532302418
29189,R,199493,328151,8575,536219,1,0.372036425415735
29195,R,6451,2904,164,9519,1,0.6776972371047378
29197,R,1606,373,24,2003,1,0.8017973040439341
29199,R,1560,388,36,1984,1,0.7862903225806451
29201,R,13769,3753,196,17718,1,0.7771193136922904
29203,R,3165,706,35,3906,1,0.8102918586789555
29205,R,2700,592,58,3350,1,0.8059701492537313
29207,R,11484,1819,123,13426,1,0.8553552807984508
29209,R,14800,3506,177,18483,1,0.8007358112860467
29211,R,1974,478,19,2471,1,0.7988668555240793
29213,R,20508,5339,422,26269,1,0.7806920705013514
29215,R,9478,1716,121,11315,1,0.8376491383119753
29217,R,7155,1903,127,9185,1,0.778987479586282
29219,R,13222,4769,382,18373,1,0.7196429543351658
29221,R,8047,1804,121,9972,1,0.8069594865623746
29223,R,4987,845,46,5878,1,0.8484178291936033
29225,R,14880,3573,326,18779,1,0.7923744608339102
29227,R,877,215,15,1107,1,0.7922312556458898
29229,R,7453,1168,118,8739,1,0.8528435747797231
29510,R,21474,110089,2230,133793,1,0.16050167049098235
30001,R,3923,1608,130,5661,1,0.6929871047518106
30003,R,2207,2491,86,4784,1,0.4613294314381271
30005,R,1469,1589,59,3117,1,0.4712864934231633
30007,R,3173,835,89,4097,1,0.7744691237490847
30009,R,4468,2421,163,7052,1,0.6335791264889393
30011,R,775,74,15,864,1,0.8969907407407407
30013,R,23315,15456,1114,39885,1,0.5845555973423593
30015,R,1891,991,83,2965,1,0.6377740303541315
30017,R,4205,1514,141,5860,1,0.7175767918088737
30019,R,799,195,20,1014,1,0.7879684418145957
30021,R,3758,962,105,4825,1,0.778860103626943
30023,R,2186,2562,143,4891,1,0.44694336536495605
30025,R,1375,172,28,1575,1,0.873015873015873
30027,R,4869,1496,142,6507,1,0.7482710926694329
30029,R,38321,20274,1341,59936,1,0.639365323011212
30031,R,31696,37044,2239,70979,1,0.4465546147452063
30033,R,764,41,8,813,1,0.939729397293973
30035,R,1884,3610,123,5617,1,0.3354103614028841
30037,R,414,78,11,503,1,0.8230616302186878
30039,R,1419,638,45,2102,1,0.6750713606089439
30041,R,3957,2981,244,7182,1,0.5509607351712615
30043,R,5345,2625,181,8151,1,0.6557477610109189
30045,R,1040,275,29,1344,1,0.7738095238095238
30047,R,9322,6916,388,16626,1,0.5606880789125466
30049,R,21409,19743,1113,42265,1,0.5065420560747663
30051,R,821,249,13,1083,1,0.7580794090489381
30053,R,8672,2835,240,11747,1,0.7382310377117562
30055,R,956,155,17,1128,1,0.8475177304964538
30057,R,4191,1771,125,6087,1,0.6885165105963529
30059,R,833,258,19,1110,1,0.7504504504504504
30061,R,1828,686,49,2563,1,0.7132266874756145
30063,R,26347,43357,1791,71495,1,0.36851528078886636
30065,R,2423,413,45,2881,1,0.8410274210343631
30067,R,6025,5280,261,11566,1,0.520923396161162
30069,R,298,39,11,348,1,0.8563218390804598
30071,R,1936,416,30,2382,1,0.8127623845507976
30073,R,2031,903,61,2995,1,0.6781302170283806
30075,R,970,154,12,1136,1,0.8538732394366197
30077,R,2355,752,72,3179,1,0.7407989933941491
30079,R,603,126,15,744,1,0.8104838709677419
30081,R,19114,8763,630,28507,1,0.6705019819693409
30083,R,4800,875,123,5798,1,0.8278716798896171
30085,R,1996,1910,111,4017,1,0.49688822504356484
30087,R,2486,1199,88,3773,1,0.6588921282798834
30089,R,5660,1820,142,7622,1,0.7425872474416164
30091,R,1403,574,53,2030,1,0.6911330049261084
30093,R,7745,10392,521,18658,1,0.4151034408832672
30095,R,4462,1156,106,5724,1,0.7795248078266946
30097,R,1840,549,57,2446,1,0.7522485690923958
30099,R,2608,1007,64,3679,1,0.7088882848600163
30101,R,1596,467,56,2119,1,0.7531854648419065
30103,R,373,78,9,460,1,0.8108695652173913
30105,R,3135,1030,96,4261,1,0.7357427833841821
30107,R,823,225,20,1068,1,0.7705992509363296
30109,R,516,77,5,598,1,0.862876254180602
30111,R,50772,30679,2370,83821,1,0.6057193304780425
31001,R,10085,4213,304,14602,1,0.6906588138611149
31003,R,3093,452,38,3583,1,0.8632430923806865
31005,R,260,21,3,284,1,0.9154929577464789
31007,R,362,43,5,410,1,0.8829268292682927
31009,R,280,35,2,317,1,0.8832807570977917
31011,R,2653,499,65,3217,1,0.8246813801678583
31013,R,4002,1051,128,5181,1,0.7724377533294731
31015,R,1010,135,8,1153,1,0.8759757155247181
31017,R,1470,191,18,1679,1,0.8755211435378202
31019,R,16640,6350,599,23589,1,0.7054135402094196
31021,R,2580,1063,88,3731,1,0.6915036183328866
31023,R,3542,873,83,4498,1,0.7874610938194754
31025,R,10121,4737,426,15284,1,0.6621957602721801
31027,R,4174,725,97,4996,1,0.8354683746997598
31029,R,1740,226,27,1993,1,0.8730556949322629
31031,R,2844,373,48,3265,1,0.8710566615620214
31033,R,3813,855,97,4765,1,0.8002098635886674
31035,R,2848,632,78,3558,1,0.8004496908375491
31037,R,2636,1025,56,3717,1,0.7091740651062685
31039,R,3507,870,74,4451,1,0.7879128285778477
31041,R,5090,786,117,5993,1,0.8493242115801769
31043,R,3926,2744,124,6794,1,0.5778628201354136
31045,R,2931,1082,108,4121,1,0.711235137102645
31047,R,6524,2497,157,9178,1,0.7108302462410111
31049,R,871,141,20,1032,1,0.8439922480620154
31051,R,2335,651,97,3083,1,0.7573791761271489
31053,R,10984,5544,348,16876,1,0.6508651339179901
31055,R,119159,150350,5442,274951,1,0.43338267545853626
31057,R,883,105,11,999,1,0.8838838838838838
31059,R,2359,693,82,3134,1,0.7527121888959796
31061,R,1437,276,11,1724,1,0.8335266821345708
31063,R,1229,189,22,1440,1,0.8534722222222222
31065,R,2163,399,39,2601,1,0.831603229527105
31067,R,7445,3385,238,11068,1,0.672659920491507
31069,R,1016,161,18,1195,1,0.8502092050209205
31071,R,933,133,9,1075,1,0.867906976744186
31073,R,893,215,10,1118,1,0.7987477638640429
31075,R,375,20,7,402,1,0.9328358208955224
31077,R,1016,229,13,1258,1,0.8076311605723371
31079,R,16189,7681,504,24374,1,0.664191351440059
31081,R,4309,1118,106,5533,1,0.778781854328574
31083,R,1615,282,31,1928,1,0.8376556016597511
31085,R,494,34,6,534,1,0.9250936329588015
31087,R,1264,175,30,1469,1,0.8604492852280463
31089,R,4769,686,82,5537,1,0.8612967310818133
31091,R,376,59,7,442,1,0.8506787330316742
31093,R,2786,648,67,3501,1,0.7957726363896029
31095,R,2616,1016,84,3716,1,0.7039827771797632
31097,R,1518,647,64,2229,1,0.6810228802153432
31099,R,2822,701,81,3604,1,0.7830188679245284
31101,R,3544,763,57,4364,1,0.8120989917506874
31103,R,476,49,4,529,1,0.8998109640831758
31105,R,1563,268,43,1874,1,0.8340448239060833
31107,R,3721,905,71,4697,1,0.7922077922077922
31109,R,70092,82293,3706,156091,1,0.44904574895413574
31111,R,13071,3692,344,17107,1,0.7640731864149178
31113,R,407,38,5,450,1,0.9044444444444445
31115,R,370,75,9,454,1,0.8149779735682819
31117,R,275,17,10,302,1,0.9105960264900662
31119,R,11940,3478,347,15765,1,0.7573739295908658
31121,R,3419,743,95,4257,1,0.8031477566361287
31123,R,2113,386,58,2557,1,0.8263590144700821
31125,R,1437,359,32,1828,1,0.7861050328227571
31127,R,2428,921,74,3423,1,0.7093193105463044
31129,R,1857,409,37,2303,1,0.8063395570994355
31131,R,5649,2490,176,8315,1,0.679374624173181
31133,R,1071,322,36,1429,1,0.7494751574527642
31135,R,1321,199,24,1544,1,0.8555699481865285
31137,R,4157,752,100,5009,1,0.8299061688959872
31139,R,3462,480,64,4006,1,0.8642036944583126
31141,R,12186,3260,227,15673,1,0.7775154724685766
31143,R,2291,530,58,2879,1,0.7957624175060785
31145,R,4525,811,116,5452,1,0.8299706529713866
31147,R,3073,996,57,4126,1,0.7447891420261755
31149,R,744,84,13,841,1,0.8846611177170036
31151,R,3631,1986,153,5770,1,0.6292894280762565
31153,R,51979,41206,2488,95673,1,0.5432985272751978
31155,R,9108,3331,296,12735,1,0.7151943462897526
31157,R,10952,4196,321,15469,1,0.7079966384381666
31159,R,6490,2438,214,9142,1,0.7099103040910085
31161,R,2292,340,40,2672,1,0.8577844311377245
31163,R,1322,343,33,1698,1,0.7785630153121319
31165,R,642,72,15,729,1,0.8806584362139918
31167,R,2561,532,68,3161,1,0.8101866497943688
31169,R,2308,624,48,2980,1,0.774496644295302
31171,R,377,45,5,427,1,0.882903981264637
31173,R,1180,1122,23,2325,1,0.5075268817204301
31175,R,1901,412,27,2340,1,0.8123931623931624
31177,R,8583,3554,276,12413,1,0.6914525094658825
31179,R,3055,1022,123,4200,1,0.7273809523809524
31181,R,1511,335,30,1876,1,0.8054371002132196
31183,R,438,59,5,502,1,0.8725099601593626
31185,R,5337,1630,176,7143,1,0.747165056698866
32001,D,9372,3051,467,12890,0,0.7270752521334368
32003,D,430930,521852,19728,972510,0,0.4431111248213386
32005,D,21630,11571,924,34125,0,0.6338461538461538
32007,D,16741,4557,669,21967,0,0.7620976919925343
32009,D,400,74,13,487,0,0.8213552361396304
32011,D,895,105,17,1017,0,0.880039331366765
32013,D,5877,1689,205,7771,0,0.7562733238965385
32015,D,2198,496,71,2765,0,0.7949367088607595
32017,D,2067,330,49,2446,0,0.8450531479967294
32019,D,20914,8473,851,30238,0,0.6916462729016469
32021,D,1423,829,83,2335,0,0.6094218415417559
32023,D,17528,7288,562,25378,0,0.6906769642997872
32027,D,1731,547,42,2320,0,0.7461206896551724
32029,D,1908,902,67,2877,0,0.6631908237747653
32031,D,116760,128128,7254,252142,0,0.4630723957135265
32033,D,3403,859,107,4369,0,0.7788967727168689
32510,D,16113,12735,891,29739,0,0.5418137798849995
33001,D,20899,16894,598,38391,0,0.5443723789429814
33003,D,16150,16649,422,33221,0,0.4861382860239005
33005,D,17898,25522,800,44220,0,0.40474898236092266
33007,D,8617,7640,258,16515,0,0.521768089615501
33009,D,19905,33180,881,53966,0,0.368843345810325
33011,D,104625,122344,3972,230941,0,0.4530377888724826
33013,D,39711,48533,1561,89805,0,0.44219141473191914
33015,D,95858,100064,2876,198798,0,0.48218794957695754
33017,D,30489,41721,1386,73596,0,0.41427523234958424
33019,D,11508,12390,482,24380,0,0.47202625102543067
34001,D,64438,73808,1608,139854,0,0.4607519270095957
34003,D,204417,285967,5081,495465,0,0.4125760649087221
34005,D,103345,154595,3383,261323,0,0.39546844326752717
34007,D,86207,175065,3145,264417,0,0.32602669268617374
34009,D,33158,23941,560,57659,0,0.5750706741358678
34011,D,28952,32742,665,62359,0,0.46427941435879344
34013,D,75475,266820,2738,345033,0,0.21874719229754835
34015,D,83340,86702,2415,172457,0,0.4832508973251303
34017,D,65698,181452,2495,249645,0,0.263165695287308
34019,D,43153,39457,1588,84198,0,0.5125181120691703
34021,D,51641,122532,2295,176468,0,0.2926366253371716
34023,D,143467,226250,4396,374113,0,0.38348573826624577
34025,D,191808,181291,4870,377969,0,0.5074701893541533
34027,D,141134,153881,4054,299069,0,0.47191116431325214
34029,D,217740,119456,4202,341398,0,0.637789325069274
34031,D,92009,129097,2322,223428,0,0.4118060404246558
34033,D,18827,14479,596,33902,0,0.5553359683794467
34035,D,71996,111173,2574,185743,0,0.38761083863187307
34037,D,51698,34481,1690,87869,0,0.5883531165712594
34039,D,80002,170245,2453,252700,0,0.31658884052235853
34041,D,34769,24901,1076,60746,0,0.5723669048167781
35001,D,116135,193757,7698,317590,0,0.3656758714065304
35003,D,1698,595,33,2326,0,0.7300085984522786
35005,D,15656,6381,406,22443,0,0.6975894488259146
35006,D,3975,4745,183,8903,0,0.4464787150398742
35007,D,3271,2611,134,6016,0,0.543716755319149
35009,D,10444,4307,350,15101,0,0.691609827163764
35011,D,656,231,14,901,0,0.7280799112097669
35013,D,32802,47957,1882,82641,0,0.3969216248593313
35015,D,17454,5424,344,23222,0,0.7516148479889759
35017,D,6553,7590,292,14435,0,0.45396605472809143
35019,D,917,1234,38,2189,0,0.4189127455459114
35021,D,319,179,7,505,0,0.6316831683168317
35023,D,1120,823,31,1974,0,0.5673758865248227
35025,D,16531,4061,326,20918,0,0.7902763170475189
35027,D,6942,3194,170,10306,0,0.6735882010479333
35028,D,4278,7554,461,12293,0,0.348002928495892
35029,D,4408,3563,132,8103,0,0.543996050845366
35031,D,7801,18029,656,26486,0,0.29453296080948427
35033,D,903,1745,38,2686,0,0.3361876396128071
35035,D,14521,8485,565,23571,0,0.6160536252174282
35037,D,2634,1170,69,3873,0,0.6800929512006196
35039,D,5408,10990,230,16628,0,0.3252345441424104
35041,D,4634,1802,172,6608,0,0.701271186440678
35043,D,34174,40588,1800,76562,0,0.4463572007000862
35045,D,32874,18083,1337,52294,0,0.6286380846751062
35047,D,3421,7888,222,11531,0,0.2966785187754748
35049,D,18329,62530,1368,82227,0,0.2229073175477641
35051,D,3542,2265,138,5945,0,0.5957947855340623
35053,D,3255,3722,183,7160,0,0.454608938547486
35055,D,3715,13121,345,17181,0,0.21622722775158607
35057,D,4772,2344,165,7281,0,0.6554044774069496
35059,D,1388,383,18,1789,0,0.7758524315259921
35061,D,17364,14263,650,32277,0,0.537968212659169
36001,D,51081,99474,2897,153452,0,0.332879336861038
36003,D,14135,6048,518,20701,0,0.6828172552050625
36005,D,67740,355374,2601,425715,0,0.1591205383883584
36007,D,43800,47010,1908,92718,0,0.47240018119459004
36009,D,22155,11879,717,34751,0,0.6375356104860291
36011,D,19512,16149,746,36407,0,0.5359408904880929
36013,D,34853,23087,1231,59171,0,0.5890216491186561
36015,D,21922,16636,839,39397,0,0.5564383074853415
36017,D,13482,8290,503,22275,0,0.6052525252525253
36019,D,16514,18364,553,35431,0,0.46608901809150177
36021,D,14464,20386,657,35507,0,0.4073562959416453
36023,D,10789,10369,504,21662,0,0.49806112085679993
36025,D,13387,9143,428,22958,0,0.5831082846937886
36027,D,66872,81443,2338,150653,0,0.44388097150405237
36029,D,197527,267174,8320,473021,0,0.41758611139885965
36031,D,8976,9947,336,19259,0,0.46606781245132145
36033,D,9668,9253,343,19264,0,0.5018687707641196
36035,D,15378,7931,408,23717,0,0.648395665556352
36037,D,18876,9625,703,29204,0,0.6463498150938227
36039,D,14271,10346,517,25134,0,0.5677966101694916
36041,D,2225,1178,56,3459,0,0.6432494940734317
36043,D,18870,9937,507,29314,0,0.6437197243637852
36045,D,25629,17307,912,43848,0,0.5844964422550629
36047,D,202772,703310,7164,913246,0,0.22203436970980436
36049,D,8894,3824,219,12937,0,0.6874855066862487
36051,D,18182,12477,728,31387,0,0.5792844171153663
36053,D,18408,14807,814,34029,0,0.5409503658644098
36055,D,145661,225746,8179,379586,0,0.3837364918621867
36057,D,12745,7977,408,21130,0,0.6031708471367724
36059,D,326716,396504,7419,730639,0,0.4471647420956177
36061,D,85185,603040,6679,694904,0,0.12258527796645292
36063,D,56068,46029,1983,104080,0,0.5387009992313605
36065,D,57180,41567,1968,100715,0,0.5677406543216006
36067,D,91715,138991,5227,235933,0,0.3887332420644844
36069,D,29039,29025,1582,59646,0,0.48685578244978706
36071,D,84996,84684,2419,172099,0,0.4938785234080384
36073,D,12126,5587,434,18147,0,0.6682096214250289
36075,D,32138,21143,1188,54469,0,0.5900236831959463
36077,D,14382,12975,641,27998,0,0.5136795485391814
36079,D,29283,24953,728,54964,0,0.5327669019722
36081,D,212665,569038,6157,787860,0,0.26992739826872797
36083,D,36500,40969,1776,79245,0,0.46059688308410623
36085,D,123320,90997,1836,216153,0,0.5705218063131208
36087,D,73186,75802,1307,150295,0,0.4869490002994112
36089,D,24608,19361,810,44779,0,0.5495433127135487
36091,D,61305,68471,2828,132604,0,0.4623163705468915
36093,D,30741,42465,1620,74826,0,0.41083313286825435
36095,D,9903,5345,434,15682,0,0.6314883305700804
36097,D,5621,3903,214,9738,0,0.5772232491271309
36099,D,8329,6914,358,15601,0,0.5338760335875905
36101,D,29474,15790,901,46165,0,0.6384490414816419
36103,D,381253,381021,9267,771541,0,0.4941448348175923
36105,D,18665,15489,482,34636,0,0.5388901720752973
36107,D,14791,9634,605,25030,0,0.5909308829404715
36109,D,11096,33619,976,45691,0,0.24284870105710096
36111,D,37590,57970,1841,97401,0,0.38593032925739984
36113,D,17699,17642,790,36131,0,0.4898563560377515
36115,D,15941,11565,587,28093,0,0.5674367280105365
36117,D,26204,17456,1054,44714,0,0.5860356935188085
36119,D,144713,312371,4994,462078,0,0.31317872740100156
36121,D,13898,5073,423,19394,0,0.71661338558317
36123,D,6208,4219,264,10691,0,0.580675334393415
37001,R,46056,38825,1060,85941,1,0.5359025377875519
37003,R,15888,4145,169,20202,1,0.7864567864567864
37005,R,4527,1486,55,6068,1,0.746044825313118
37007,R,5321,5789,74,11184,1,0.4757689556509299
37009,R,11451,4164,176,15791,1,0.7251599012095498
37011,R,7172,2191,79,9442,1,0.7595848337216692
37013,R,16437,9633,204,26274,1,0.6255994519296643
37015,R,3817,5939,52,9808,1,0.3891721044045677
37017,R,9676,7326,106,17108,1,0.5655833528173954
37019,R,55850,33310,852,90012,1,0.6204728258454428
37021,R,62412,96515,2227,161154,1,0.38728173051863435
37023,R,31019,13118,396,44533,1,0.69653964475782
37025,R,63237,52162,1493,116892,1,0.5409865516887383
37027,R,32119,10245,385,42749,1,0.7513392126131605
37029,R,4312,1537,89,5938,1,0.7261704277534523
37031,R,30028,12093,494,42615,1,0.7046345183620791
37033,R,7089,4860,91,12040,1,0.5887873754152824
37035,R,56588,25689,976,83253,1,0.679711241636938
37037,R,21186,26787,516,48489,1,0.4369238383963373
37039,R,12628,3583,183,16394,1,0.7702818104184458
37041,R,4471,3247,59,7777,1,0.5749003471775749
37043,R,5112,1699,71,6882,1,0.7428073234524848
37045,R,33798,16955,484,51237,1,0.659640494174132
37047,R,16832,9446,144,26422,1,0.637044886836727
37049,R,31032,21148,791,52971,1,0.5858299824432236
37051,R,60032,84469,2312,146813,1,0.4089011191107055
37053,R,11657,4195,262,16114,1,0.7234082164577386
37055,R,13938,9936,301,24175,1,0.5765460186142709
37057,R,64658,22636,1079,88373,1,0.7316488067622464
37059,R,18228,6713,298,25239,1,0.7222156186853679
37061,R,13793,8767,134,22694,1,0.6077817925442849
37063,R,32459,144688,2229,179376,1,0.18095508875211846
37065,R,9206,16089,157,25452,1,0.3617004557598617
37067,R,85064,113033,2582,200679,1,0.4238809242621301
37069,R,20901,15879,481,37261,1,0.5609350258983924
37071,R,73033,40959,1277,115269,1,0.6335875213630725
37073,R,3367,2546,52,5965,1,0.5644593461860855
37075,R,3710,905,44,4659,1,0.7963082206482077
37077,R,16647,14565,330,31542,1,0.5277724938177668
37079,R,4874,3832,38,8744,1,0.5574107959743825
37081,R,107294,173086,3359,283739,1,0.3781432936607234
37083,R,10080,15545,117,25742,1,0.3915779659700101
37085,R,35177,22093,913,58183,1,0.6045924067167385
37087,R,22834,13144,479,36457,1,0.6263269056696931
37089,R,40032,27211,976,68219,1,0.5868159896802944
37091,R,3479,7097,44,10620,1,0.3275894538606403
37093,R,9453,11804,343,21600,1,0.4376388888888889
37095,R,1418,1046,24,2488,1,0.569935691318328
37097,R,67010,33888,1235,102133,1,0.6561052744950212
37099,R,11356,9591,417,21364,1,0.5315483991761842
37101,R,68353,41257,1529,111139,1,0.6150226293200407
37103,R,3280,2197,44,5521,1,0.5940952725955443
37105,R,16469,12143,347,28959,1,0.5687005766773715
37107,R,14590,13605,185,28380,1,0.5140944326990838
37109,R,36341,13274,519,50134,1,0.7248773287589261
37111,R,16883,5832,250,22965,1,0.7351622033529284
37113,R,14211,6230,224,20665,1,0.6876844906847326
37115,R,7979,4901,159,13039,1,0.6119334304777974
37117,R,6532,5911,88,12531,1,0.5212672572021387
37119,R,179211,378107,7801,565119,1,0.3171208188009959
37121,R,7090,1867,70,9027,1,0.7854215132380636
37123,R,8411,4327,102,12840,1,0.6550623052959501
37125,R,36764,20779,675,58218,1,0.6314885430622832
37127,R,25827,25947,418,52192,1,0.49484595340282034
37129,R,63331,66138,2054,131523,1,0.48152034244960956
37131,R,3989,6069,47,10105,1,0.3947550717466601
37133,R,46078,24266,1742,72086,1,0.6392087229142969
37135,R,20176,63594,952,84722,1,0.23814357545855858
37137,R,4849,2713,59,7621,1,0.6362682062721428
37139,R,9770,9832,245,19847,1,0.49226583362724846
37141,R,21956,11723,438,34117,1,0.6435501362956884
37143,R,4903,2492,78,7473,1,0.6560952763281146
37145,R,13184,8465,222,21871,1,0.602807370490604
37147,R,38982,47252,1131,87365,1,0.44619698964116067
37149,R,7689,4518,126,12333,1,0.6234492824130382
37151,R,56894,15618,704,73216,1,0.7770705856643356
37153,R,11830,8754,158,20742,1,0.5703403721916883
37155,R,27806,19020,295,47121,1,0.5900978332378345
37157,R,31301,15992,442,47735,1,0.6557243113019797
37159,R,49297,23114,830,73241,1,0.6730792861921602
37161,R,24891,9135,331,34357,1,0.7244811828739413
37163,R,17411,10966,195,28572,1,0.6093728125437491
37165,R,7473,7186,99,14758,1,0.5063694267515924
37167,R,25458,8129,305,33892,1,0.7511507140328101
37169,R,20142,5286,239,25667,1,0.7847430552849963
37171,R,27538,8721,322,36581,1,0.7527951668899155
37173,R,4161,2780,110,7051,1,0.5901290597078429
37175,R,11636,8444,264,20344,1,0.5719622493118364
37177,R,1044,758,12,1814,1,0.5755237045203969
37179,R,80382,48725,1545,130652,1,0.6152374246088846
37181,R,8391,12431,152,20974,1,0.40006674930866787
37183,R,226197,393336,10010,629543,1,0.3593034947573081
37185,R,3752,6400,124,10276,1,0.3651226158038147
37187,R,2781,3396,26,6203,1,0.44833145252297274
37189,R,14451,17122,532,32105,1,0.4501168042361003
37191,R,30709,24215,541,55465,1,0.5536644730911385
37193,R,27592,7511,311,35414,1,0.7791268989665104
37195,R,19581,20754,342,40677,1,0.4813776827199646
37197,R,15933,3763,192,19888,1,0.8011363636363636
37199,R,7516,3688,127,11331,1,0.6633130350366252
38001,R,981,258,30,1269,1,0.7730496453900709
38003,R,3568,1820,161,5549,1,0.6429987385114435
38005,R,1094,822,39,1955,1,0.5595907928388747
38007,R,541,72,21,634,1,0.8533123028391167
38009,R,2575,821,65,3461,1,0.7440046229413464
38011,R,1395,228,30,1653,1,0.8439201451905626
38013,R,994,137,20,1151,1,0.8635968722849696
38015,R,34744,14348,1368,50460,1,0.6885453824811733
38017,R,42619,40311,2495,85425,1,0.4989054726368159
38019,R,1499,474,40,2013,1,0.7446597118728266
38021,R,1742,608,63,2413,1,0.7219229175300456
38023,R,904,265,30,1199,1,0.7539616346955796
38025,R,1951,342,39,2332,1,0.8366209262435678
38027,R,854,383,22,1259,1,0.6783161239078633
38029,R,1738,237,27,2002,1,0.8681318681318682
38031,R,1362,373,33,1768,1,0.7703619909502263
38033,R,871,137,16,1024,1,0.8505859375
38035,R,16987,12880,874,30741,1,0.5525844962753326
38037,R,1145,207,28,1380,1,0.8297101449275363
38039,R,907,308,34,1249,1,0.7261809447558046
38041,R,1091,196,23,1310,1,0.832824427480916
38043,R,1215,221,22,1458,1,0.8333333333333334
38045,R,1645,527,44,2216,1,0.7423285198555957
38047,R,930,128,14,1072,1,0.8675373134328358
38049,R,2364,564,68,2996,1,0.7890520694259012
38051,R,1153,261,30,1444,1,0.7984764542936288
38053,R,4482,814,110,5406,1,0.8290788013318535
38055,R,4198,1230,96,5524,1,0.7599565532223027
38057,R,3856,704,102,4662,1,0.8271128271128271
38059,R,12243,3872,432,16547,1,0.7398924276303862
38061,R,2824,1256,75,4155,1,0.6796630565583635
38063,R,1141,586,43,1770,1,0.6446327683615819
38065,R,918,129,18,1065,1,0.8619718309859155
38067,R,2460,786,66,3312,1,0.7427536231884058
38069,R,1585,497,38,2120,1,0.7476415094339622
38071,R,3577,1639,128,5344,1,0.6693488023952096
38073,R,1418,945,86,2449,1,0.5790118415679869
38075,R,1065,220,32,1317,1,0.8086560364464692
38077,R,5072,2510,191,7773,1,0.6525151164286633
38079,R,1257,2482,60,3799,1,0.33087654645959463
38081,R,1266,738,62,2066,1,0.6127783155856728
38083,R,688,104,16,808,1,0.8514851485148515
38085,R,258,804,48,1110,1,0.23243243243243245
38087,R,380,44,2,426,1,0.892018779342723
38089,R,12110,2499,396,15005,1,0.8070643118960347
38091,R,652,392,38,1082,1,0.6025878003696857
38093,R,6994,2676,249,9919,1,0.7051114023591087
38095,R,830,317,25,1172,1,0.7081911262798635
38097,R,2522,1493,110,4125,1,0.6113939393939394
38099,R,3324,1333,95,4752,1,0.6994949494949495
38101,R,19974,7293,845,28112,1,0.7105150825270348
38103,R,1893,442,32,2367,1,0.7997465145754119
38105,R,11739,2169,362,14270,1,0.822634898388227
39001,R,9870,2156,119,12145,1,0.8126801152737753
39003,R,33116,14149,728,47993,1,0.6900172941887358
39005,R,19407,6541,450,26398,1,0.735169331009925
39007,R,26890,16497,755,44142,1,0.6091704046033256
39009,R,10862,14772,414,26048,1,0.4169993857493858
39011,R,20798,4651,324,25773,1,0.8069685329608505
39013,R,23560,9138,383,33081,1,0.7121912880505427
39015,R,16480,4380,236,21096,1,0.7811907470610542
39017,R,114392,69613,2670,186675,1,0.6127869291549485
39019,R,10745,3251,212,14208,1,0.7562640765765766
39021,R,14589,5062,315,19966,1,0.7306921767003907
39023,R,39032,24076,1074,64182,1,0.6081455859898414
39025,R,74570,34092,1784,110446,1,0.6751715770602829
39027,R,15488,4697,337,20522,1,0.7547022707338467
39029,R,35726,13359,769,49854,1,0.7166125085248927
39031,R,12325,4125,289,16739,1,0.7363044387358862
39033,R,15436,4916,331,20683,1,0.7463133974761882
39035,R,202699,416176,6624,625499,1,0.3240596707588661
39037,R,22004,4731,393,27128,1,0.81111766440578
39039,R,13038,5981,350,19369,1,0.6731374877381383
39041,R,66356,57735,1923,126014,1,0.5265764121446823
39043,R,22160,17493,675,40328,1,0.5494941479865106
39045,R,50797,31224,1256,83277,1,0.6099763440085498
39047,R,9473,2975,164,12612,1,0.7511100539169046
39049,R,211237,409144,9887,630268,1,0.33515425184207354
39051,R,15731,6664,370,22765,1,0.6910169119262025
39053,R,10645,2990,164,13799,1,0.7714327125153997
39055,R,34143,21201,666,56010,1,0.6095875736475629
39057,R,52072,34798,1722,88592,1,0.58777316236229
39059,R,13407,4577,244,18228,1,0.7355167873601053
39061,R,177886,246266,6600,430752,1,0.412966161503603
39063,R,26310,11757,690,38757,1,0.6788451118507625
39065,R,9949,3062,236,13247,1,0.7510379708613271
39067,R,5792,1768,95,7655,1,0.756629653821032
39069,R,10479,4062,219,14760,1,0.7099593495934959
39071,R,15678,3799,195,19672,1,0.7969703131354209
39073,R,9737,3880,202,13819,1,0.7046095954844779
39075,R,10796,1994,151,12941,1,0.8342477397419056
39077,R,18956,7759,470,27185,1,0.6972963031083318
39079,R,11309,3311,174,14794,1,0.7644315262944437
39081,R,22828,10018,457,33303,1,0.6854637720325496
39083,R,22340,8589,460,31389,1,0.7117142948166555
39085,R,73278,55514,1692,130484,1,0.5615860948468778
39087,R,20306,7489,328,28123,1,0.7220424563524517
39089,R,59514,33055,1591,94160,1,0.6320518266779949
39091,R,17964,5055,341,23360,1,0.7690068493150685
39093,R,79520,75667,2211,157398,1,0.5052160764431568
39095,R,81763,115411,3385,200559,1,0.4076755468465639
39097,R,13835,5698,315,19848,1,0.6970475614671503
39099,R,59903,57641,1402,118946,1,0.5036150858372707
39101,R,19023,8269,526,27818,1,0.6838378028614566
39103,R,64598,39800,1410,105808,1,0.6105209435959473
39105,R,8316,2492,143,10951,1,0.7593827047758196
39107,R,19452,4030,271,23753,1,0.818928135393424
39109,R,41371,15663,921,57955,1,0.7138469502199982
39111,R,5463,1605,80,7148,1,0.7642697257974258
39113,R,129034,135064,4302,268400,1,0.48075260804769
39115,R,5041,1725,81,6847,1,0.7362348473784139
39117,R,14077,4048,327,18452,1,0.7628983308042488
39119,R,27867,11971,622,40460,1,0.6887543252595155
39121,R,5135,1170,38,6343,1,0.8095538388775028
39123,R,14628,9008,366,24002,1,0.6094492125656196
39125,R,7086,2213,162,9461,1,0.7489694535461368
39127,R,12357,4098,217,16672,1,0.7411828214971209
39129,R,20593,7304,360,28257,1,0.7287751707541494
39131,R,9157,3110,145,12412,1,0.7377537866580728
39133,R,45990,35661,1201,82852,1,0.5550861777627577
39135,R,17022,4493,294,21809,1,0.7805034618735385
39137,R,16412,3195,308,19915,1,0.8241024353502385
39139,R,41472,17640,848,59960,1,0.6916611074049366
39141,R,22278,10557,461,33296,1,0.6690893801057184
39143,R,18896,10596,580,30072,1,0.6283586060122373
39145,R,22609,9080,353,32042,1,0.7056051432494851
39147,R,17086,8266,451,25803,1,0.6621710653799946
39149,R,20422,4465,361,25248,1,0.8088561470215463
39151,R,111097,75904,2846,189847,1,0.5851922864201172
39153,R,124833,151668,3891,280392,1,0.4452088504664898
39155,R,55194,44519,1269,100982,1,0.5465726565130419
39157,R,30458,12889,655,44002,1,0.6921958092813963
39159,R,21669,11141,635,33445,1,0.647899536552549
39161,R,11650,3067,243,14960,1,0.7787433155080213
39163,R,4632,1331,64,6027,1,0.7685415629666501
39165,R,87988,46069,2038,136095,1,0.6465189757154929
39167,R,22307,9243,481,32031,1,0.6964190940026849
39169,R,36759,16660,838,54257,1,0.6774978343808172
39171,R,13452,4842,355,18649,1,0.7213255402434446
39173,R,35757,30617,1203,67577,1,0.5291297334892049
39175,R,8462,2733,193,11388,1,0.7430628731998595
40001,R,5585,1387,77,7049,1,0.7923109660944815
40003,R,1978,232,37,2247,1,0.8802848242100578
40005,R,4557,765,53,5375,1,0.8478139534883721
40007,R,1968,190,16,2174,1,0.9052437902483901
40009,R,6767,1048,108,7923,1,0.8540956708317556
40011,R,3136,688,51,3875,1,0.8092903225806451
40013,R,12344,3323,249,15916,1,0.7755717516964061
40015,R,7013,2670,115,9798,1,0.7157583180240865
40017,R,43550,16742,1268,61560,1,0.7074398960363872
40019,R,14699,4470,220,19389,1,0.7581102687090618
40021,R,11223,6027,346,17596,1,0.6378154125937713
40023,R,4698,1082,37,5817,1,0.8076328004125838
40025,R,970,70,11,1051,1,0.922930542340628
40027,R,66677,49827,2488,118992,1,0.5603485948635203
40029,R,2091,374,38,2503,1,0.8353975229724331
40031,R,20905,13747,762,35414,1,0.5903032698932625
40033,R,2117,393,40,2550,1,0.8301960784313726
40035,R,4686,1217,98,6001,1,0.7808698550241626
40037,R,23294,6577,487,30358,1,0.7673100994795441
40039,R,8060,2369,211,10640,1,0.7575187969924813
40041,R,13557,3472,154,17183,1,0.7889774777396263
40043,R,2124,214,14,2352,1,0.9030612244897959
40045,R,1688,162,19,1869,1,0.9031567683253077
40047,R,16970,4919,410,22299,1,0.761020673572806
40049,R,8878,1865,127,10870,1,0.8167433302667894
40051,R,18538,4144,317,22999,1,0.8060350450019566
40053,R,1916,280,26,2222,1,0.8622862286228623
40055,R,1605,328,26,1959,1,0.8192955589586524
40057,R,747,177,6,930,1,0.8032258064516129
40059,R,1327,136,18,1481,1,0.8960162052667117
40061,R,4165,783,43,4991,1,0.8345021037868162
40063,R,3875,919,46,4840,1,0.8006198347107438
40065,R,6392,1646,148,8186,1,0.7808453457121916
40067,R,2026,319,29,2374,1,0.8534119629317607
40069,R,3441,738,44,4223,1,0.8148235851290552
40071,R,12834,4040,288,17162,1,0.7478149399836849
40073,R,5521,854,68,6443,1,0.8568989601117492
40075,R,2673,699,38,3410,1,0.7838709677419354
40077,R,3437,762,38,4237,1,0.8111871607269294
40079,R,15213,3299,234,18746,1,0.8115331270671077
40081,R,12013,2609,207,14829,1,0.8101018275001686
40083,R,15608,5455,399,21462,1,0.7272388407417761
40085,R,3305,711,41,4057,1,0.8146413606112891
40087,R,15295,3582,257,19134,1,0.7993623915543012
40089,R,9485,1858,76,11419,1,0.8306331552675366
40091,R,6172,2031,94,8297,1,0.7438833313245752
40093,R,3084,320,46,3450,1,0.8939130434782608
40095,R,4891,1100,55,6046,1,0.8089646046973206
40097,R,12749,3581,217,16547,1,0.7704719888801596
40099,R,4612,1156,88,5856,1,0.787568306010929
40101,R,16526,8027,376,24929,1,0.6629227004693329
40103,R,3821,1003,82,4906,1,0.7788422339991846
40105,R,3610,712,56,4378,1,0.8245774326176336
40107,R,3058,896,57,4011,1,0.762403390675642
40109,R,145050,141724,5788,292562,1,0.495792344870489
40111,R,9668,4357,207,14232,1,0.6793142214727375
40113,R,14121,6002,280,20403,1,0.6921041023378914
40115,R,8545,2686,157,11388,1,0.7503512469265894
40117,R,5267,1363,117,6747,1,0.7806432488513413
40119,R,17813,10904,734,29451,1,0.6048351499100201
40121,R,13851,3768,222,17841,1,0.7763578274760383
40123,R,10805,4117,290,15212,1,0.71029450433868
40125,R,20240,7275,481,27996,1,0.7229604229175597
40127,R,4016,668,39,4723,1,0.8503070082574635
40129,R,1629,168,27,1824,1,0.8930921052631579
40131,R,34031,9589,729,44349,1,0.7673453741910753
40133,R,6011,2150,117,8278,1,0.7261415800918096
40135,R,12113,3035,173,15321,1,0.7906141896743032
40137,R,15560,3154,251,18965,1,0.8204587397838123
40139,R,4505,894,99,5498,1,0.8193888686795199
40141,R,2076,597,25,2698,1,0.7694588584136397
40143,R,150574,108996,5312,264882,1,0.5684568977884492
40145,R,26165,8464,549,35178,1,0.7437887315936097
40147,R,17076,5790,487,23353,1,0.7312122639489573
40149,R,4086,598,68,4752,1,0.8598484848484849
40151,R,2993,591,72,3656,1,0.8186542669584245
40153,R,6611,1005,137,7753,1,0.8527021798013672
41001,D,7352,2346,193,9891,0,0.7433019917096351
41003,D,14878,35827,1620,52325,0,0.28433827042522697
41005,D,110509,139043,6176,255728,0,0.43213492460739533
41007,D,10218,12916,630,23764,0,0.4299781181619256
41009,D,17150,13835,1032,32017,0,0.5356529343786114
41011,D,21829,14243,824,36896,0,0.5916359496964441
41013,D,11287,3801,289,15377,0,0.7340183390778435
41015,D,8484,6058,312,14854,0,0.5711592836946278
41017,D,55646,65962,2676,124284,0,0.44773261240384926
41019,D,43298,19160,1585,64043,0,0.6760770107583967
41021,D,834,324,18,1176,0,0.7091836734693877
41023,D,3545,929,100,4574,0,0.775032794053345
41025,D,3475,894,81,4450,0,0.7808988764044944
41027,D,3955,8764,279,12998,0,0.3042775811663333
41029,D,63869,59478,3074,126421,0,0.5052087865148986
41031,D,7189,4393,291,11873,0,0.6054914511917797
41033,D,31751,18451,1138,51340,0,0.6184456564082587
41035,D,25308,10388,860,36556,0,0.6923076923076923
41037,D,3470,792,81,4343,0,0.7989868754317292
41039,D,80336,134366,5824,220526,0,0.3642926457651252
41041,D,12460,17385,741,30586,0,0.407375923625188
41043,D,43486,26512,2146,72144,0,0.6027666888445331
41045,D,8187,3260,306,11753,0,0.6965881051646389
41047,D,79002,80872,4434,164308,0,0.4808165153248777
41049,D,3586,1371,144,5101,0,0.7029994118800236
41051,D,82995,367249,9844,460088,0,0.18038940376623602
41053,D,23732,22917,1283,47932,0,0.4951180839522657
41055,D,921,260,26,1207,0,0.7630488815244407
41057,D,8354,8066,382,16802,0,0.4972027139626235
41059,D,21270,10707,884,32861,0,0.6472718420011564
41061,D,10298,4254,318,14870,0,0.6925353059852051
41063,D,3404,1625,102,5131,0,0.6634184369518612
41065,D,7035,6604,398,14037,0,0.5011754648429152
41067,D,99073,209940,8457,317470,0,0.31207043185182853
41069,D,711,217,32,960,0,0.740625
41071,D,29551,27174,1821,58546,0,0.5047484029651897
42001,D,37523,18207,810,56540,0,0.6636540502299257
42003,D,282324,429065,8344,719733,0,0.3922621305400753
42005,D,27489,8457,424,36370,0,0.7558152323343414
42007,D,54759,38122,1241,94122,0,0.581787467329636
42009,D,23025,4367,182,27574,0,0.8350257488938856
42011,D,109736,92895,2909,205540,0,0.5338912133891214
42013,D,45306,17636,653,63595,0,0.7124144979951254
42015,D,21600,8046,513,30159,0,0.7162041181736795
42017,D,187367,204712,4155,396234,0,0.47286956697305127
42019,D,74359,37508,1438,113305,0,0.6562728917523498
42021,D,48085,21730,759,70574,0,0.681341570550061
42023,D,1771,634,29,2434,0,0.727608874281019
42025,D,21984,11212,433,33629,0,0.6537214903803265
42027,D,36372,40055,1066,77493,0,0.4693585227052766
42029,D,128565,182372,3565,314502,0,0.4087891332964496
42031,D,14578,4678,237,19493,0,0.7478582055096702
42033,D,29203,9673,546,39422,0,0.7407792603115012
42035,D,11902,5502,221,17625,0,0.675290780141844
42037,D,20098,10532,541,31171,0,0.6447659683680343
42039,D,28559,12924,521,42004,0,0.6799114370059994
42041,D,77212,62245,2138,141595,0,0.5453017408806808
42043,D,66408,78983,1977,147368,0,0.45062700179143367
42045,D,118532,206423,2976,327931,0,0.3614540863779271
42047,D,12140,4522,244,16906,0,0.7180882526913522
42049,D,66869,68286,1928,137083,0,0.4877993624300606
42051,D,41227,20444,468,62139,0,0.6634641690403772
42053,D,1882,728,36,2646,0,0.7112622826908541
42055,D,57245,22422,1116,80783,0,0.7086268150477204
42057,D,6824,1085,68,7977,0,0.8554594459069825
42059,D,12579,4911,179,17669,0,0.7119248401154564
42061,D,17061,5445,286,22792,0,0.7485521235521235
42063,D,28089,12634,475,41198,0,0.6818049419874751
42065,D,17960,4527,337,22824,0,0.7868909919383106
42067,D,9649,2253,141,12043,0,0.8012123225110023
42069,D,52334,61991,1085,115410,0,0.4534615717875401
42071,D,160209,115847,4183,280239,0,0.5716870242899811
42073,D,29597,15978,501,46076,0,0.6423517666464102
42075,D,46731,23932,989,71652,0,0.6521939373639256
42077,D,84259,98288,2166,184713,0,0.45616172115660514
42079,D,86929,64873,1519,153321,0,0.5669738652891646
42081,D,41462,16971,821,59254,0,0.699733351334931
42083,D,14083,5098,285,19466,0,0.7234665570738724
42085,D,36143,21067,744,57954,0,0.6236497912137212
42087,D,16670,4603,229,21502,0,0.7752767184447958
42089,D,38726,44060,1043,83829,0,0.4619642367199895
42091,D,185460,319511,5186,510157,0,0.3635351470233673
42093,D,5844,3771,156,9771,0,0.5980964077371814
42095,D,83854,85087,2001,170942,0,0.490540651215032
42097,D,28952,12677,654,42283,0,0.6847196272733723
42099,D,18293,5950,409,24652,0,0.7420493266266429
42101,D,132740,603790,4847,741377,0,0.17904520911762842
42103,D,19213,13019,322,32554,0,0.5901886096946611
42105,D,7239,1726,99,9064,0,0.7986540158870256
42107,D,48871,20727,1005,70603,0,0.6921943826749571
42109,D,13983,4910,247,19140,0,0.730564263322884
42111,D,31466,8654,423,40543,0,0.7761142490688898
42113,D,2619,921,55,3595,0,0.7285118219749652
42115,D,15207,6236,309,21752,0,0.699108127988231
42117,D,15742,4955,378,21075,0,0.7469513641755635
42119,D,12356,7475,284,20115,0,0.6142679592344021
42121,D,18569,7585,374,26528,0,0.6999773823884198
42123,D,14237,6066,347,20650,0,0.6894430992736077
42125,D,72080,45088,1310,118478,0,0.6083829909350259
42127,D,18637,9191,261,28089,0,0.6634981665420627
42129,D,130218,72129,2350,204697,0,0.6361500168541796
42131,D,9936,4704,218,14858,0,0.6687306501547987
42133,D,146733,88114,3624,238471,0,0.6153075216693015
44001,D,9745,18050,364,28159,0,0.34607052807272987
44003,D,42001,49113,1165,92279,0,0.45515230984297617
44005,D,15722,29486,575,45783,0,0.3434025730074482
44007,D,102636,166288,2719,271643,0,0.3778341426062884
44009,D,29818,44549,975,75342,0,0.39576862838788457
45001,R,8215,4101,117,12433,1,0.6607415748411486
45003,R,51589,32275,1321,85185,1,0.6056113165463404
45005,R,835,2718,40,3593,1,0.23239632618981354
45007,R,67565,27169,1359,96093,1,0.7031209349276222
45009,R,2417,4010,55,6482,1,0.3728787411292811
45011,R,5492,4720,109,10321,1,0.5321189807189226
45013,R,53194,43419,1222,97835,1,0.5437113507435989
45015,R,57397,45223,1838,104458,1,0.5494744299144153
45017,R,4305,3905,81,8291,1,0.519237727656495
45019,R,93297,121485,4075,218857,1,0.42629205371543977
45021,R,18043,6983,244,25270,1,0.714008705975465
45023,R,8660,6941,156,15757,1,0.5495970045059339
45025,R,11297,7431,148,18876,1,0.5984848484848485
45027,R,8361,8250,122,16733,1,0.4996713081933903
45029,R,10440,8602,241,19283,1,0.5414095317118706
45031,R,16832,15220,365,32417,1,0.5192337353857543
45033,R,6582,6436,83,13101,1,0.5024043966109457
45035,R,41913,33824,1541,77278,1,0.5423665208726934
45037,R,8184,4953,167,13304,1,0.6151533373421527
45039,R,4625,7382,129,12136,1,0.38109756097560976
45041,R,32615,31153,742,64510,1,0.5055805301503643
45043,R,20487,15822,359,36668,1,0.5587160466892113
45045,R,150021,103030,5104,258155,1,0.5811276171292441
45047,R,19431,12145,430,32006,1,0.6071049178279073
45049,R,3906,5323,76,9305,1,0.4197743148844707
45051,R,118821,59180,1743,179744,1,0.6610568363895318
45053,R,7078,7185,131,14394,1,0.4917326663887731
45055,R,20471,12699,459,33629,1,0.6087305599333909
45057,R,30312,18937,619,49868,1,0.607844710034491
45059,R,20004,10159,325,30488,1,0.656127000787195
45061,R,3008,5329,94,8431,1,0.35677855533151465
45063,R,92817,49301,2450,144568,1,0.6420300481434342
45065,R,2958,2687,52,5697,1,0.5192206424433913
45067,R,5711,8872,121,14704,1,0.3883977149075082
45069,R,5044,6290,112,11446,1,0.4406779661016949
45071,R,11443,6958,230,18631,1,0.614191401427728
45073,R,29698,10414,556,40668,1,0.7302547457460411
45075,R,13603,27295,307,41205,1,0.33012983861181894
45077,R,42907,13645,994,57546,1,0.7456122058874639
45079,R,58313,132570,2939,193822,1,0.3008585196726894
45081,R,6210,2963,101,9274,1,0.6696139745525124
45083,R,93560,52926,2169,148655,1,0.6293767448118126
45085,R,21000,27379,541,48920,1,0.42927228127555195
45087,R,8183,4935,139,13257,1,0.6172588066681753
45089,R,5532,10289,164,15985,1,0.3460744447919925
45091,R,82727,59008,2315,144050,1,0.5742936480388754
46003,R,1052,317,36,1405,1,0.7487544483985765
46005,R,4808,2107,166,7081,1,0.6790001412229911
46007,R,694,466,23,1183,1,0.5866441251056635
46009,R,2235,721,45,3001,1,0.7447517494168611
46011,R,8000,6110,457,14567,1,0.5491865174709961
46013,R,10580,6538,429,17547,1,0.6029520715791873
46015,R,1750,673,67,2490,1,0.7028112449799196
46017,R,183,352,14,549,1,0.3333333333333333
46019,R,3731,939,132,4802,1,0.7769679300291545
46021,R,747,117,9,873,1,0.8556701030927835
46023,R,2552,1177,54,3783,1,0.6745968807824478
46025,R,1373,437,40,1850,1,0.7421621621621621
46027,R,2456,3083,159,5698,1,0.431028431028431
46029,R,8958,3837,366,13161,1,0.6806473672213358
46031,R,647,622,14,1283,1,0.5042868277474669
46033,R,3852,1522,120,5494,1,0.7011285038223517
46035,R,5613,2648,193,8454,1,0.6639460610361959
46037,R,1869,1052,43,2964,1,0.6305668016194332
46039,R,1699,609,42,2350,1,0.7229787234042553
46041,R,790,1131,45,1966,1,0.40183112919633773
46043,R,1468,216,23,1707,1,0.8599882835383714
46045,R,1538,417,30,1985,1,0.7748110831234257
46047,R,2878,1053,111,4042,1,0.7120237506185056
46049,R,964,198,20,1182,1,0.8155668358714044
46051,R,2618,1056,71,3745,1,0.6990654205607477
46053,R,1771,455,32,2258,1,0.7843224092116917
46055,R,1026,105,6,1137,1,0.9023746701846965
46057,R,2372,647,64,3083,1,0.7693804735647097
46059,R,1433,373,30,1836,1,0.7805010893246187
46061,R,1793,557,38,2388,1,0.7508375209380235
46063,R,748,49,16,813,1,0.9200492004920049
46065,R,5522,2953,248,8723,1,0.6330390920554855
46067,R,2944,762,61,3767,1,0.7815237589593841
46069,R,564,136,10,710,1,0.7943661971830986
46071,R,738,359,18,1115,1,0.6618834080717488
46073,R,721,270,15,1006,1,0.7166998011928429
46075,R,498,90,11,599,1,0.8313856427378965
46077,R,1904,819,56,2779,1,0.6851385390428212
46079,R,3681,2068,124,5873,1,0.6267665588285374
46081,R,8753,4537,538,13828,1,0.6329910326873012
46083,R,19617,11981,798,32396,1,0.60553772070626
46085,R,1042,525,30,1597,1,0.6524733876017533
46087,R,2068,769,63,2900,1,0.713103448275862
46089,R,1075,222,27,1324,1,0.8119335347432024
46091,R,1287,858,33,2178,1,0.5909090909090909
46093,R,9875,3285,510,13670,1,0.7223847841989759
46095,R,449,298,22,769,1,0.5838751625487646
46097,R,787,320,31,1138,1,0.6915641476274165
46099,R,49249,40482,2595,92326,1,0.5334250373675887
46101,R,1951,1179,76,3206,1,0.6085464753587024
46102,R,297,2829,74,3200,1,0.0928125
46103,R,35063,20606,1849,57518,1,0.6096004728954414
46105,R,1401,239,29,1669,1,0.8394248052726183
46107,R,1139,227,14,1380,1,0.8253623188405798
46109,R,2404,1828,75,4307,1,0.5581611330392384
46111,R,905,257,23,1185,1,0.7637130801687764
46115,R,2104,998,61,3163,1,0.6651912741068606
46117,R,1203,421,28,1652,1,0.7282082324455206
46119,R,726,185,19,930,1,0.7806451612903226
46121,R,532,1963,44,2539,1,0.20953131153997637
46123,R,2161,495,40,2696,1,0.8015578635014837
46125,R,3290,1139,119,4548,1,0.7233948988566403
46127,R,5944,2725,186,8855,1,0.6712591756070017
46129,R,1966,565,49,2580,1,0.762015503875969
46135,R,6581,4016,303,10900,1,0.6037614678899083
46137,R,404,481,21,906,1,0.445916114790287
47001,R,23184,11741,409,35334,1,0.6561385634233317
47003,R,14354,4453,161,18968,1,0.7567482075073808
47005,R,5668,1529,36,7233,1,0.7836305820544726
47007,R,4725,971,34,5730,1,0.824607329842932
47009,R,47369,17932,846,66147,1,0.7161171330521414
47011,R,35204,9851,515,45570,1,0.7725257845073513
47013,R,12331,2441,103,14875,1,0.8289747899159664
47015,R,5190,1261,65,6516,1,0.7965009208103131
47017,R,9205,2559,92,11856,1,0.7764001349527665
47019,R,19584,4529,249,24362,1,0.8038748871192841
47021,R,14438,5514,206,20158,1,0.7162416906439131
47023,R,5952,1412,93,7457,1,0.7981762102722274
47025,R,10604,2202,83,12889,1,0.8227170455427109
47027,R,2733,735,22,3490,1,0.7830945558739255
47029,R,12162,2533,97,14792,1,0.8222011898323418
47031,R,17883,5705,266,23854,1,0.7496855873228808
47033,R,4673,1382,31,6086,1,0.7678278015116661
47035,R,25168,6728,233,32129,1,0.7833421519499517
47037,R,100218,199703,3964,303885,1,0.32978922947825656
47039,R,4229,904,25,5158,1,0.8198914307871268
47041,R,6672,1750,61,8483,1,0.786514204880349
47043,R,17643,6106,277,24026,1,0.734329476400566
47045,R,11768,3158,97,15023,1,0.7833322239233176
47047,R,15690,7027,152,22869,1,0.6860815951725042
47049,R,7441,1214,36,8691,1,0.8561730525831319
47051,R,13987,4864,171,19022,1,0.7353064872253181
47053,R,16259,5771,165,22195,1,0.7325523766614103
47055,R,9784,3298,70,13152,1,0.7439172749391727
47057,R,8565,1467,63,10095,1,0.8484398216939079
47059,R,22259,5199,216,27674,1,0.8043289730432898
47061,R,4802,988,34,5824,1,0.8245192307692307
47063,R,18811,5500,203,24514,1,0.7673574284082565
47065,R,92108,75522,2291,169921,1,0.5420636648795617
47067,R,2372,362,4,2738,1,0.8663257852447042
47069,R,5760,4180,46,9986,1,0.5768075305427599
47071,R,9559,1775,58,11392,1,0.8390976123595506
47073,R,20405,4083,216,24704,1,0.8259795984455959
47075,R,3343,4012,34,7389,1,0.45242928677764244
47077,R,9797,2092,83,11972,1,0.8183260942198463
47079,R,11239,3548,169,14956,1,0.7514709815458679
47081,R,7577,2130,78,9785,1,0.7743484925907
47083,R,2718,871,21,3610,1,0.7529085872576178
47085,R,6120,2017,47,8184,1,0.7478005865102639
47087,R,4118,1135,48,5301,1,0.7768345595170723
47089,R,18651,4654,187,23492,1,0.7939298484590499
47091,R,6468,1246,45,7759,1,0.8336125789405852
47093,R,124540,91422,2968,218930,1,0.5688576257251177
47095,R,1492,526,9,2027,1,0.7360631475086334
47097,R,5674,3193,50,8917,1,0.6363126612089268
47099,R,15334,3195,118,18647,1,0.8223306698128385
47101,R,4474,1072,27,5573,1,0.8027992104790956
47103,R,12281,2919,141,15341,1,0.8005345153510202
47105,R,21713,6948,286,28947,1,0.7500950012091063
47107,R,18198,4361,187,22746,1,0.8000527565286204
47109,R,9093,1943,61,11097,1,0.8194106515274399
47111,R,8096,1307,43,9446,1,0.8570823629049333
47113,R,23943,18390,350,42683,1,0.560949324086873
47115,R,9911,3177,96,13184,1,0.7517445388349514
47117,R,11043,3605,131,14779,1,0.7472088774612626
47119,R,31464,14418,496,46378,1,0.678425115356419
47121,R,4467,1008,34,5509,1,0.8108549646033762
47123,R,16783,3764,152,20699,1,0.8108121165273685
47125,R,42187,32472,1478,76137,1,0.5540932792203528
47127,R,2888,573,31,3492,1,0.827033218785796
47129,R,6930,1167,95,8192,1,0.845947265625
47131,R,10790,2589,71,13450,1,0.8022304832713755
47133,R,7918,2033,47,9998,1,0.7919583916783357
47135,R,2775,615,20,3410,1,0.8137829912023461
47137,R,2381,525,11,2917,1,0.8162495714775454
47139,R,6792,1492,44,8328,1,0.8155619596541787
47141,R,23759,9185,438,33382,1,0.7117308729255287
47143,R,11050,2369,133,13552,1,0.8153778040141676
47145,R,19230,6043,325,25598,1,0.7512305648878819
47147,R,24536,8692,308,33536,1,0.731631679389313
47149,R,81480,59341,1907,142728,1,0.57087607196906
47151,R,8004,986,32,9022,1,0.8871647084903569
47153,R,5855,1298,64,7217,1,0.8112789247609811
47155,R,33783,8721,425,42929,1,0.7869505462507862
47157,R,129815,246105,2645,378565,1,0.3429133702270416
47159,R,7136,1802,64,9002,1,0.7927127305043323
47161,R,4950,1232,67,6249,1,0.7921267402784445
47163,R,55860,17272,793,73925,1,0.7556307067974298
47165,R,63454,27680,965,92099,1,0.6889759932246822
47167,R,20070,6837,233,27140,1,0.7394988946204863
47169,R,2936,1012,35,3983,1,0.7371328144614612
47171,R,6599,1615,51,8265,1,0.7984271022383546
47173,R,6803,1249,44,8096,1,0.8402915019762845
47175,R,2342,544,23,2909,1,0.8050876589893434
47177,R,11850,3924,125,15899,1,0.7453298949619472
47179,R,40444,18638,701,59783,1,0.6765133900941739
47181,R,5795,820,28,6643,1,0.8723468312509408
47183,R,10396,3020,96,13512,1,0.7693901716992303
47185,R,9606,2143,106,11855,1,0.8102910164487558
47187,R,86469,50161,1528,138158,1,0.625870380289234
47189,R,50296,22254,832,73382,1,0.6853996892971028
48001,R,15110,3955,156,19221,1,0.7861193486291036
48003,R,4943,850,70,5863,1,0.8430837455227699
48005,R,25076,9143,349,34568,1,0.7254107845406156
48007,R,9239,2916,134,12289,1,0.7518105622914801
48009,R,4300,446,49,4795,1,0.8967674661105318
48011,R,1035,75,2,1112,1,0.9307553956834532
48013,R,12039,5876,201,18116,1,0.664550673437845
48015,R,11447,2951,156,14554,1,0.7865191699876323
48017,R,1434,409,16,1859,1,0.771382463690156
48019,R,10057,2505,150,12712,1,0.7911422278162367
48021,R,20516,15474,659,36649,1,0.5597969930966739
48023,R,1494,183,23,1700,1,0.8788235294117647
48025,R,6006,3288,120,9414,1,0.6379859783301466
48027,R,67893,57014,2420,127327,1,0.5332176207717138
48029,R,308618,448452,11635,768705,1,0.4014778100831919
48031,R,5443,1911,87,7441,1,0.7314877032656901
48033,R,397,16,3,416,1,0.9543269230769231
48035,R,7469,1561,96,9126,1,0.8184308568923954
48037,R,27116,10747,391,38254,1,0.7088409055262195
48039,R,90433,62228,2277,154938,1,0.5836721785488389
48041,R,47530,35349,2064,84943,1,0.5595516993748749
48043,R,2461,2258,103,4822,1,0.5103691414350892
48045,R,639,78,8,725,1,0.8813793103448276
48047,R,998,1470,16,2484,1,0.40177133655394526
48049,R,13698,2107,158,15963,1,0.8581093779364781
48051,R,6743,1788,78,8609,1,0.7832500871181322
48053,R,18767,5639,302,24708,1,0.7595515622470455
48055,R,8031,6672,237,14940,1,0.5375502008032128
48057,R,5641,2148,67,7856,1,0.7180498981670062
48059,R,6012,734,86,6832,1,0.879976580796253
48061,R,49032,64063,1064,114159,1,0.42950621501589886
48063,R,3626,1394,38,5058,1,0.7168841439304072
48065,R,2779,297,40,3116,1,0.8918485237483954
48067,R,11033,2795,96,13924,1,0.7923728813559322
48069,R,1602,466,15,2083,1,0.7690830532885262
48071,R,17353,3997,300,21650,1,0.8015242494226328
48073,R,15101,4210,197,19508,1,0.7740926799261841
48075,R,1943,310,26,2279,1,0.8525669153137341
48077,R,5069,614,58,5741,1,0.8829472217383731
48079,R,809,177,14,1000,1,0.809
48081,R,1586,178,15,1779,1,0.8915120854412592
48083,R,3641,451,32,4124,1,0.8828806983511154
48085,R,252318,230945,7321,490584,1,0.5143217063744435
48087,R,1048,155,13,1216,1,0.8618421052631579
48089,R,7472,2420,69,9961,1,0.750125489408694
48091,R,62740,24826,1297,88863,1,0.7060306314214014
48093,R,5177,853,54,6084,1,0.8509204470742933
48095,R,1058,197,13,1268,1,0.8343848580441641
48097,R,15596,3210,182,18988,1,0.8213608594902043
48099,R,15438,7565,487,23490,1,0.6572158365261813
48101,R,540,113,9,662,1,0.8157099697885196
48103,R,1247,241,14,1502,1,0.8302263648468708
48105,R,1220,344,10,1574,1,0.7750952986022872
48107,R,1396,527,30,1953,1,0.7147977470558116
48109,R,415,438,11,864,1,0.48032407407407407
48111,R,1389,197,23,1609,1,0.8632691112492231
48113,R,307076,598576,13302,918954,1,0.33415818419637977
48115,R,2951,808,30,3789,1,0.7788334652942729
48117,R,3294,1264,52,4610,1,0.7145336225596529
48119,R,2162,403,27,2592,1,0.8341049382716049
48121,R,222480,188695,6513,417688,1,0.5326463772002068
48123,R,6567,1494,57,8118,1,0.8089430894308943
48125,R,853,130,5,988,1,0.8633603238866396
48127,R,1384,2264,18,3666,1,0.37752318603382434
48129,R,1438,198,12,1648,1,0.8725728155339806
48131,R,2443,2575,35,5053,1,0.4834751632693449
48133,R,7237,983,72,8292,1,0.8727689339122046
48135,R,32697,11367,517,44581,1,0.733429039276822
48137,R,893,168,5,1066,1,0.8377110694183865
48139,R,56717,27565,1174,85456,1,0.6636982774761281
48141,R,84331,178126,4191,266648,1,0.3162633884371906
48143,R,13684,2916,253,16853,1,0.8119622619118257
48145,R,4177,1899,57,6133,1,0.681069623349095
48147,R,12171,2655,178,15004,1,0.8111836843508398
48149,R,10171,2661,109,12941,1,0.7859516266130901
48151,R,1448,352,26,1826,1,0.7929901423877328
48153,R,1584,438,17,2039,1,0.7768513977439921
48155,R,445,99,7,551,1,0.8076225045372051
48157,R,157718,195552,4119,357389,1,0.4413062517313068
48159,R,4161,804,44,5009,1,0.83070473148333
48161,R,6991,1635,85,8711,1,0.8025485018941568
48163,R,2823,2422,34,5279,1,0.5347603712824398
48165,R,5355,576,64,5995,1,0.8932443703085905
48167,R,93911,58842,2306,155059,1,0.6056468827994506
48169,R,1413,231,9,1653,1,0.8548094373865699
48171,R,12514,3176,156,15846,1,0.7897261138457655
48173,R,611,39,3,653,1,0.9356814701378254
48175,R,3085,877,26,3988,1,0.7735707121364093
48177,R,5627,1948,72,7647,1,0.7358441218778606
48179,R,6840,829,113,7782,1,0.8789514263685428
48181,R,44163,14506,770,59439,1,0.7429970221571696
48183,R,32493,14796,664,47953,1,0.6776009842971242
48185,R,9432,2833,148,12413,1,0.75984854587932
48187,R,47553,28805,1234,77592,1,0.6128595731518713
48189,R,7177,2279,128,9584,1,0.7488522537562604
48191,R,995,168,5,1168,1,0.8518835616438356
48193,R,3616,641,92,4349,1,0.8314555070131064
48195,R,1849,166,30,2045,1,0.9041564792176039
48197,R,1330,241,9,1580,1,0.8417721518987342
48199,R,23858,3474,303,27635,1,0.8633254930341958
48201,R,700630,918193,21948,1640771,1,0.427012666606126
48203,R,21466,7908,336,29710,1,0.7225176708179064
48205,R,1868,195,15,2078,1,0.8989412897016362
48207,R,1840,353,21,2214,1,0.8310749774164409
48209,R,47680,59524,2153,109357,1,0.43600318223799117
48211,R,1486,206,28,1720,1,0.8639534883720931
48213,R,28911,7060,339,36310,1,0.7962269347287249
48215,R,90527,128199,2126,220852,1,0.40989893684458373
48217,R,11926,2860,145,14931,1,0.7987408746902418
48219,R,6536,1482,77,8095,1,0.8074119827053737
48221,R,26496,5648,390,32534,1,0.8144095407880986
48223,R,12719,3046,174,15939,1,0.797979797979798
48225,R,7060,2314,63,9437,1,0.7481191056479813
48227,R,8054,2069,117,10240,1,0.7865234375
48229,R,779,371,15,1165,1,0.6686695278969957
48231,R,29163,8906,505,38574,1,0.7560273759527143
48233,R,7681,965,125,8771,1,0.8757268270436667
48235,R,759,120,10,889,1,0.8537682789651294
48237,R,3418,331,33,3782,1,0.9037546271813856
48239,R,5231,1033,76,6340,1,0.8250788643533123
48241,R,12542,2954,112,15608,1,0.8035622757560226
48243,R,784,501,20,1305,1,0.6007662835249042
48245,R,47570,46073,1096,94739,1,0.5021163406833511
48247,R,833,1197,6,2036,1,0.40913555992141454
48249,R,7453,6119,97,13669,1,0.5452483722291316
48251,R,54628,16464,913,72005,1,0.7586695368377196
48253,R,5660,999,82,6741,1,0.8396380358997182
48255,R,3968,1234,47,5249,1,0.7559535149552296
48257,R,37624,18405,674,56703,1,0.6635275029539883
48259,R,20083,6020,335,26438,1,0.7596262954837734
48261,R,127,65,2,194,1,0.654639175257732
48263,R,411,47,4,462,1,0.8896103896103896
48265,R,20879,6524,334,27737,1,0.7527490355842377
48267,R,1987,284,21,2292,1,0.8669284467713787
48269,R,151,8,0,159,1,0.949685534591195
48271,R,1144,446,13,1603,1,0.7136618839675608
48273,R,5504,5314,126,10944,1,0.5029239766081871
48275,R,1180,265,11,1456,1,0.8104395604395604
48277,R,16760,4458,200,21418,1,0.7825193762256046
48279,R,3521,840,47,4408,1,0.7987749546279492
48281,R,8086,2144,169,10399,1,0.7775747668045004
48283,R,1335,1052,19,2406,1,0.5548628428927681
48285,R,8804,1333,54,10191,1,0.8638995191835933
48287,R,6255,1750,81,8086,1,0.7735592381894633
48289,R,7523,1072,71,8666,1,0.8681052388645281
48291,R,23302,5785,247,29334,1,0.7943683098111407
48293,R,6789,2213,93,9095,1,0.7464540956569544
48295,R,1205,131,17,1353,1,0.8906134515890614
48297,R,4199,819,36,5054,1,0.8308270676691729
48299,R,10079,2465,115,12659,1,0.796192432261632
48301,R,60,4,2,66,1,0.9090909090909091
48303,R,78861,40017,1893,120771,1,0.6529796060312493
48305,R,1853,428,12,2293,1,0.8081116441343218
48307,R,2904,490,42,3436,1,0.8451688009313155
48309,R,59543,36688,1540,97771,1,0.6090047150995694
48311,R,460,53,3,516,1,0.8914728682170543
48313,R,4169,1088,40,5297,1,0.7870492731734944
48315,R,3470,1339,55,4864,1,0.7134046052631579
48317,R,1857,288,15,2160,1,0.8597222222222223
48319,R,1991,457,21,2469,1,0.8063993519643581
48321,R,9845,3733,148,13726,1,0.7172519306425761
48323,R,6881,8332,133,15346,1,0.44839046005473737
48325,R,15642,6773,229,22644,1,0.690779014308426
48327,R,823,197,8,1028,1,0.8005836575875487
48329,R,45624,12329,903,58856,1,0.7751801005844774
48331,R,7984,2496,96,10576,1,0.7549167927382754
48333,R,2217,271,17,2505,1,0.8850299401197604
48335,R,2170,397,12,2579,1,0.8414113997673517
48337,R,8615,1097,102,9814,1,0.8778275932341553
48339,R,193382,74377,3692,271451,1,0.7124011331695224
48341,R,4359,1062,87,5508,1,0.7913943355119826
48343,R,3872,1669,46,5587,1,0.6930374082691964
48345,R,604,46,2,652,1,0.9263803680981595
48347,R,17378,9000,385,26763,1,0.6493292979112955
48349,R,13800,5101,220,19121,1,0.7217195753360179
48351,R,4882,1173,39,6094,1,0.8011158516573679
48353,R,4131,1162,63,5356,1,0.7712845407020165
48355,R,64617,60925,1772,127314,1,0.5075404118949998
48357,R,2812,302,40,3154,1,0.891566265060241
48359,R,917,81,11,1009,1,0.908820614469772
48361,R,29186,6357,427,35970,1,0.8113983875451766
48363,R,10179,2178,128,12485,1,0.8152983580296356
48365,R,9326,2057,68,11451,1,0.8144266876255349
48367,R,62045,13017,1038,76100,1,0.8153088042049934
48369,R,2135,488,27,2650,1,0.8056603773584906
48371,R,3215,1382,71,4668,1,0.6887317909168809
48373,R,18573,5387,221,24181,1,0.7680823787270998
48375,R,22820,9921,580,33321,1,0.6848533957564299
48377,R,721,1463,33,2217,1,0.3252142534957149
48379,R,5155,842,56,6053,1,0.8516438129852966
48381,R,50796,12802,1039,64637,1,0.7858656806473072
48383,R,942,172,10,1124,1,0.8380782918149466
48385,R,1643,320,19,1982,1,0.8289606458123108
48387,R,4517,1246,43,5806,1,0.7779882879779538
48389,R,2254,1395,38,3687,1,0.6113371304583672
48391,R,2210,1108,47,3365,1,0.6567607726597325
48393,R,529,17,4,550,1,0.9618181818181818
48395,R,5646,2374,79,8099,1,0.6971231016174836
48397,R,36726,16412,732,53870,1,0.6817523668089845
48399,R,3807,552,50,4409,1,0.8634611022907689
48401,R,16534,4629,205,21368,1,0.7737738674653688
48403,R,4784,669,34,5487,1,0.8718789866958265
48405,R,3007,980,15,4002,1,0.7513743128435783
48407,R,10161,2337,140,12638,1,0.8040037980693148
48409,R,16516,8988,384,25888,1,0.6379789864029666
48411,R,2308,287,7,2602,1,0.8870099923136049
48413,R,940,211,8,1159,1,0.811044003451251
48415,R,4983,818,68,5869,1,0.8490373147043789
48417,R,1484,130,14,1628,1,0.9115479115479116
48419,R,7975,2068,41,10084,1,0.7908568028560096
48421,R,886,91,14,991,1,0.8940464177598385
48423,R,69080,29615,1380,100075,1,0.6902822882837871
48425,R,4105,768,66,4939,1,0.8311399068637376
48427,R,8247,9123,155,17525,1,0.4705848787446505
48429,R,3385,397,18,3800,1,0.8907894736842106
48431,R,584,51,4,639,1,0.9139280125195618
48433,R,615,116,5,736,1,0.8355978260869565
48435,R,1222,322,13,1557,1,0.7848426461143224
48437,R,1845,478,32,2355,1,0.7834394904458599
48439,R,409741,411567,12985,834293,1,0.49112362203686233
48441,R,39547,14588,977,55112,1,0.717575119756133
48443,R,334,119,5,458,1,0.7292576419213974
48445,R,2812,757,43,3612,1,0.778516057585825
48447,R,806,82,6,894,1,0.901565995525727
48449,R,7570,2856,113,10539,1,0.7182844672170036
48451,R,32313,12239,642,45194,1,0.7149842899499934
48453,R,161337,435860,10999,608196,1,0.26527139277469763
48455,R,5579,1323,36,6938,1,0.8041222254251946
48457,R,8194,1403,63,9660,1,0.84824016563147
48459,R,15809,2877,201,18887,1,0.8370307618997194
48461,R,1178,170,20,1368,1,0.8611111111111112
48463,R,6174,4073,95,10342,1,0.5969831754012763
48465,R,8284,6771,217,15272,1,0.5424305919329492
48467,R,22270,3516,208,25994,1,0.8567361698853582
48469,R,23358,10380,442,34180,1,0.6833820947922762
48471,R,15375,7884,350,23609,1,0.6512346986318777
48473,R,14260,8191,283,22734,1,0.6272543327175156
48475,R,3241,764,55,4060,1,0.7982758620689655
48477,R,12959,4261,198,17418,1,0.7440004592949822
48479,R,25898,41820,679,68397,1,0.3786423381142448
48481,R,11926,4694,141,16761,1,0.7115327247777579
48483,R,2159,168,10,2337,1,0.9238339751818571
48485,R,32069,13161,800,46030,1,0.6966978057788399
48487,R,3524,956,44,4524,1,0.7789566755083996
48489,R,2441,3108,0,5549,1,0.43989908091548025
48491,R,139729,143795,5788,289312,1,0.48296994248423847
48493,R,18463,6350,190,25003,1,0.738431388233412
48495,R,1753,358,15,2126,1,0.8245531514581373
48497,R,27032,4973,357,32362,1,0.8353006612693901
48499,R,19049,3509,215,22773,1,0.8364730162912221
48501,R,2174,420,37,2631,1,0.8263017863930064
48503,R,7110,1034,94,8238,1,0.8630735615440641
48505,R,2033,1826,15,3874,1,0.5247805885389778
48507,R,1490,2864,25,4379,1,0.3402603334094542
49001,R,2695,357,34,3086,1,0.873298768632534
49003,R,21548,4473,821,26842,1,0.8027717755755905
49005,R,38032,16650,2418,57100,1,0.6660595446584938
49007,R,6693,2392,196,9281,1,0.7211507380670187
49009,R,496,111,9,616,1,0.8051948051948052
49011,R,104135,57411,6546,168092,1,0.6195119339409371
49013,R,7513,843,140,8496,1,0.884298493408663
49015,R,4207,572,61,4840,1,0.8692148760330578
49017,R,2158,514,52,2724,1,0.7922173274596183
49019,R,2248,2806,91,5145,1,0.4369290573372206
49021,R,18989,4892,852,24733,1,0.7677596733109611
49023,R,5087,645,113,5845,1,0.8703165098374679
49025,R,2998,1083,75,4156,1,0.7213666987487969
49027,R,5404,624,96,6124,1,0.8824297844546048
49029,R,5181,1086,194,6461,1,0.801888252592478
49031,R,773,86,8,867,1,0.8915801614763552
49033,R,1157,180,19,1356,1,0.8532448377581121
49035,R,230174,289906,16571,536651,1,0.4289081730957363
49037,R,3535,3113,149,6797,1,0.5200823892893924
49039,R,10459,1794,291,12544,1,0.8337850765306123
49041,R,9052,1084,181,10317,1,0.8773868372588931
49043,R,10252,15244,469,25965,1,0.39483920662430194
49045,R,21014,8943,1253,31210,1,0.6733098365908363
49047,R,13261,1663,316,15240,1,0.8701443569553806
49049,R,192812,76033,12774,281619,1,0.6846555097489871
49051,R,10795,6187,457,17439,1,0.6190148517690235
49053,R,67294,20530,2182,90006,1,0.7476612670266427
49055,R,1229,365,16,1610,1,0.7633540372670807
49057,R,65949,40695,3801,110445,1,0.5971207388292815
50001,D,6292,14967,368,21627,0,0.2909326305081611
50003,D,7114,12705,308,20127,0,0.3534555572117057
50005,D,6551,9011,265,15827,0,0.41391293359449044
50007,D,21017,74961,1451,97429,0,0.21571605990002976
50009,D,1773,1405,53,3231,0,0.5487465181058496
50011,D,11274,13611,437,25322,0,0.44522549561646
50013,D,1810,2905,57,4772,0,0.37929589270746017
50015,D,4163,10240,239,14642,0,0.2843190820926103
50017,D,6187,10304,265,16756,0,0.3692408689424684
50019,D,6512,7147,202,13861,0,0.46980737320539645
50021,D,14672,18230,479,33381,0,0.439531469997903
50023,D,8928,25191,565,34684,0,0.2574097566601315
50025,D,6440,18767,477,25684,0,0.25073976016196853
50027,D,9971,23376,556,33903,0,0.294103766628322
51001,D,9172,7578,188,16938,0,0.541504309835872
51003,D,20804,42466,1014,64284,0,0.32362640781531954
51005,D,5859,2243,89,8191,0,0.7152972774996947
51007,D,5390,2411,80,7881,0,0.683923359979698
51009,D,11041,5672,251,16964,0,0.650848856401792
51011,D,6702,2418,119,9239,0,0.7254031821625717
51013,D,22318,105344,1836,129498,0,0.1723424299989189
51015,D,30714,10840,608,42162,0,0.7284758787533798
51017,D,1834,646,16,2496,0,0.7347756410256411
51019,D,35600,12176,708,48484,0,0.734262849599868
51021,D,2903,532,40,3475,0,0.8353956834532374
51023,D,15099,5700,264,21063,0,0.7168494516450648
51025,D,3357,4552,34,7943,0,0.4226362835200806
51027,D,8311,1587,44,9942,0,0.835948501307584
51029,D,4544,3471,93,8108,0,0.5604341391218549
51031,D,21245,8070,490,29805,0,0.7127998657943299
51033,D,8336,7657,259,16252,0,0.5129214865862664
51035,D,12659,2842,118,15619,0,0.8104872270952046
51036,D,1761,2624,54,4439,0,0.3967109709394008
51037,D,3815,2317,48,6180,0,0.6173139158576052
51041,D,93326,106935,2927,203188,0,0.45930862058783
51043,D,5192,3920,178,9290,0,0.5588805166846071
51045,D,2536,587,40,3163,0,0.8017704710717674
51047,D,16012,10617,406,27035,0,0.5922692805622342
51049,D,3019,2227,53,5299,0,0.5697301377618419
51051,D,5748,1503,44,7295,0,0.7879369431117204
51053,D,8695,6224,144,15063,0,0.5772422492199429
51057,D,3075,3038,58,6171,0,0.49829849295089934
51059,D,168401,419943,8014,596358,0,0.2823823944677526
51061,D,25106,17565,777,43448,0,0.577840176763027
51063,D,6225,3004,147,9376,0,0.663929180887372
51065,D,8155,7414,226,15795,0,0.5163026274137386
51067,D,20895,8381,354,29630,0,0.7051974350320621
51069,D,30558,17207,781,48546,0,0.6294648374737363
51071,D,6876,2156,125,9157,0,0.7509009500928252
51073,D,14875,6964,389,22228,0,0.6692010077379881
51075,D,9966,6685,242,16893,0,0.5899484993784407
51077,D,6529,1535,56,8120,0,0.804064039408867
51079,D,6866,4163,241,11270,0,0.6092280390417036
51081,D,1914,2627,23,4564,0,0.4193689745836985
51083,D,10418,7666,140,18224,0,0.5716637401229149
51085,D,44318,25307,1103,70728,0,0.6265976699468386
51087,D,63440,116572,2414,182426,0,0.3477574468551632
51089,D,16725,9127,223,26075,0,0.6414189837008629
51091,D,1092,417,22,1531,0,0.713259307642064
51093,D,13707,9399,328,23434,0,0.5849193479559615
51095,D,23153,25553,710,49416,0,0.4685324591225514
51097,D,2450,1590,64,4104,0,0.5969785575048733
51099,D,8446,5404,314,14164,0,0.59630048009037
51101,D,7320,3260,142,10722,0,0.6827084499160604
51103,D,3697,3368,71,7136,0,0.5180773542600897
51105,D,8365,1489,78,9932,0,0.8422271445831655
51107,D,82088,138372,3139,223599,0,0.3671214987544667
51109,D,13294,8269,295,21858,0,0.6081983713057004
51111,D,3537,2418,40,5995,0,0.5899916597164303
51113,D,5300,2698,106,8104,0,0.6539980256663376
51115,D,3901,1825,87,5813,0,0.671082057457423
51117,D,9266,6803,113,16182,0,0.5726115436905204
51119,D,4196,2491,77,6764,0,0.6203429923122413
51121,D,20629,23218,942,44789,0,0.4605818392908973
51125,D,4812,4327,150,9289,0,0.5180320809559694
51127,D,9631,4621,172,14424,0,0.6677066001109262
51131,D,2955,3667,100,6722,0,0.43960130913418627
51133,D,4485,3252,56,7793,0,0.5755164891569358
51135,D,4027,2971,72,7070,0,0.5695898161244696
51137,D,12426,7995,267,20688,0,0.6006380510440835
51139,D,9345,3007,134,12486,0,0.7484382508409418
51141,D,7485,1954,81,9520,0,0.7862394957983193
51143,D,23751,10115,285,34151,0,0.6954701180053293
51145,D,14055,5320,321,19696,0,0.7135966693744923
51147,D,4434,4973,136,9543,0,0.46463376296762027
51149,D,10103,7103,195,17401,0,0.5805988161599908
51153,D,81222,142863,3242,227327,0,0.3572914787948638
51155,D,12127,4925,275,17327,0,0.6998903445489698
51157,D,2812,2096,56,4964,0,0.5664786462530218
51159,D,2547,1513,31,4091,0,0.6225861647518944
51161,D,34268,21801,910,56979,0,0.6014145562400183
51163,D,8088,4086,165,12339,0,0.6554826160953076
51165,D,30349,12644,653,43646,0,0.6953443614535123
51167,D,10879,2373,116,13368,0,0.8138090963494913
51169,D,9063,1692,90,10845,0,0.8356846473029046
51171,D,16463,6836,346,23645,0,0.6962571368153944
51173,D,10963,3008,133,14104,0,0.7772972206466251
51175,D,5730,3969,87,9786,0,0.5855303494788473
51177,D,39411,34307,1301,75019,0,0.5253469121155974
51179,D,37636,40245,1376,79257,0,0.47486026470848003
51181,D,2025,2397,40,4462,0,0.45383236216943074
51183,D,2219,2827,35,5081,0,0.4367250541232041
51185,D,16731,3205,159,20095,0,0.8325951729285892
51187,D,14069,6603,365,21037,0,0.6687740647430718
51191,D,21679,6617,304,28600,0,0.758006993006993
51193,D,5318,4501,90,9909,0,0.536683822787365
51195,D,13366,3110,108,16584,0,0.8059575494452484
51197,D,11733,3143,170,15046,0,0.7798085869998671
51199,D,20241,17683,680,38604,0,0.5243239042586261
51510,D,14544,66240,1022,81806,0,0.1777864704300418
51520,D,5347,2313,125,7785,0,0.6868336544637123
51530,D,1863,825,72,2760,0,0.675
51540,D,3094,20696,311,24101,0,0.12837641591635202
51550,D,58180,66377,2098,126655,0,0.45935809877225536
51570,D,6007,2972,135,9114,0,0.6590958964230854
51580,D,1580,964,50,2594,0,0.6090979182729376
51590,D,7428,11710,195,19333,0,0.38421352092277455
51595,D,754,1612,13,2379,0,0.31693989071038253
51600,D,4007,9174,201,13382,0,0.29943207293379165
51610,D,1490,7146,114,8750,0,0.1702857142857143
51620,D,1487,2525,35,4047,0,0.36743266617247344
51630,D,4037,8517,240,12794,0,0.3155385336876661
51640,D,1838,777,18,2633,0,0.6980630459551842
51650,D,18430,46220,1006,65656,0,0.28070549530888267
51660,D,5591,11022,364,16977,0,0.32932791423690877
51670,D,4020,5430,131,9581,0,0.4195804195804196
51678,D,906,1791,48,2745,0,0.3300546448087432
51680,D,17097,18048,857,36002,0,0.47489028387311816
51683,D,6256,10356,280,16892,0,0.37035282974188966
51685,D,1979,3992,100,6071,0,0.3259759512436172
51690,D,2165,3766,73,6004,0,0.3605929380413058
51700,D,26377,53099,1438,80914,0,0.3259880861161233
51710,D,23443,64440,1608,89491,0,0.2619593031701512
51720,D,1109,464,21,1594,0,0.6957340025094103
51730,D,1584,12389,108,14081,0,0.11249201051061715
51735,D,5605,2054,160,7819,0,0.7168435861363346
51740,D,12755,30948,723,44426,0,0.2871066492594427
51750,D,2786,3358,145,6289,0,0.4429957067896327
51760,D,16603,92175,1691,110469,0,0.15029555802985453
51770,D,15607,26773,777,43157,0,0.36163310702782864
51775,D,7683,5148,220,13051,0,0.5886905217990959
51790,D,5695,6981,249,12925,0,0.4406189555125725
51800,D,20082,28676,724,49482,0,0.40584454953316357
51810,D,105087,117393,4208,226688,0,0.463575487012987
51820,D,5507,4961,209,10677,0,0.5157815865879929
51830,D,1963,4790,92,6845,0,0.2867786705624543
51840,D,5221,6610,213,12044,0,0.4334938558618399
53001,D,3907,1814,105,5826,0,0.6706144867833849
53003,D,7319,4250,302,11871,0,0.6165445202594558
53005,D,60365,38706,3117,102188,0,0.5907249383489255
53007,D,22746,19349,886,42981,0,0.5292105814196971
53009,D,23062,24721,1179,48962,0,0.4710183407540542
53011,D,126303,140324,6586,273213,0,0.4622876656674463
53013,D,1754,668,57,2479,0,0.7075433642597821
53015,D,34424,23938,1562,59924,0,0.5744609839129564
53017,D,12955,7811,404,21170,0,0.6119508738781294
53019,D,2771,1486,89,4346,0,0.6375977910722503
53021,D,18039,13340,815,32194,0,0.5603217990929987
53023,D,1069,366,45,1480,0,0.7222972972972973
53025,D,24764,11819,848,37431,0,0.6615906601480057
53027,D,19877,17354,994,38225,0,0.52
53029,D,22746,29213,1529,53488,0,0.4252542626383488
53031,D,6931,17204,489,24624,0,0.2814733593242365
53033,D,269167,907310,24483,1200960,0,0.22412653210764721
53035,D,61563,90277,5642,157482,0,0.39092086714672153
53037,D,14105,11421,650,26176,0,0.5388523838630807
53039,D,7237,5959,272,13468,0,0.5373477873477873
53041,D,29391,14520,1124,45035,0,0.6526257355390253
53043,D,5150,1713,127,6990,0,0.7367668097281831
53045,D,18710,17269,1088,37067,0,0.504761647826908
53047,D,11840,8900,388,21128,0,0.5603937902309731
53049,D,6953,6794,257,14004,0,0.49650099971436734
53051,D,5728,2593,183,8504,0,0.6735653809971778
53053,D,197730,249506,12939,460175,0,0.42968435921116965
53055,D,3057,9725,292,13074,0,0.2338228545204222
53057,D,32762,38252,1833,72847,0,0.4497371202657625
53059,D,3885,3192,186,7263,0,0.5349029326724494
53061,D,166428,256728,11941,435097,0,0.38250780860359873
53063,D,148576,135765,8643,292984,0,0.5071130164104525
53065,D,19808,7839,618,28265,0,0.7007960375022112
53067,D,65277,96608,4798,166683,0,0.39162362088515323
53069,D,1741,1165,64,2970,0,0.5861952861952862
53071,D,16400,13690,915,31005,0,0.5289469440412836
53073,D,50489,83660,3305,137454,0,0.36731561104078453
53075,D,9067,11184,691,20942,0,0.43295769267500717
53077,D,50555,43179,1825,95559,0,0.5290448832658358
54001,R,5116,1457,104,6677,1,0.7662123708252209
54003,R,33279,17186,1070,51535,1,0.6457553119239352
54005,R,6816,2041,155,9012,1,0.7563249001331558
54007,R,4120,1457,87,5664,1,0.7274011299435028
54009,R,7545,2947,164,10656,1,0.7080518018018018
54011,R,21721,14994,645,37360,1,0.5813972162740899
54013,R,2364,568,39,2971,1,0.7956916863009088
54015,R,2679,641,45,3365,1,0.7961367013372956
54017,R,2619,435,47,3101,1,0.8445662689455015
54019,R,11580,5063,219,16862,1,0.6867512750563397
54021,R,2012,599,51,2662,1,0.7558226897069872
54023,R,4871,607,31,5509,1,0.884189508077691
54025,R,10925,4655,270,15850,1,0.6892744479495269
54027,R,8033,1939,114,10086,1,0.7964505254808646
54029,R,9806,3790,204,13800,1,0.7105797101449275
54031,R,4859,1381,91,6331,1,0.7674932870004738
54033,R,20683,9215,567,30465,1,0.6789102248481864
54035,R,10093,3207,208,13508,1,0.7471868522357121
54037,R,15033,12127,543,27703,1,0.5426488105981302
54039,R,46398,34344,1502,82244,1,0.5641505763338359
54041,R,5782,1538,137,7457,1,0.7753788386750704
54043,R,6012,1711,107,7830,1,0.767816091954023
54045,R,10534,2333,159,13026,1,0.8086903116843237
54047,R,5148,1333,46,6527,1,0.7887237628313161
54049,R,16300,8901,593,25794,1,0.6319299061797318
54051,R,10435,3455,190,14080,1,0.7411221590909091
54053,R,8491,2526,186,11203,1,0.7579219851825404
54055,R,19237,5556,341,25134,1,0.765377576191613
54057,R,10040,2660,172,12872,1,0.7799875699192045
54059,R,8544,1397,81,10022,1,0.8525244462183197
54061,R,20803,20282,987,42072,1,0.4944618748811561
54063,R,5068,1345,77,6490,1,0.7808936825885978
54065,R,6537,1998,160,8695,1,0.751811385853939
54067,R,8279,2226,125,10630,1,0.7788334901222954
54069,R,12354,7223,321,19898,1,0.6208664187355513
54071,R,2782,820,57,3659,1,0.7603170265099755
54073,R,2742,699,50,3491,1,0.7854482956173017
54075,R,2895,1047,66,4008,1,0.7223053892215568
54077,R,11190,3163,219,14572,1,0.7679110623112819
54079,R,20034,7878,589,28501,1,0.70292270446651
54081,R,24673,7982,451,33106,1,0.7452727602247327
54083,R,8673,3362,165,12200,1,0.7109016393442623
54085,R,3649,586,48,4283,1,0.8519729161802475
54087,R,4213,1455,95,5763,1,0.7310428596217248
54089,R,4074,1448,63,5585,1,0.7294538943598926
54091,R,5477,1796,110,7383,1,0.741839360693485
54093,R,2841,938,65,3844,1,0.7390738813735692
54095,R,3226,631,65,3922,1,0.8225395206527282
54097,R,7771,2256,194,10221,1,0.7602974268662558
54099,R,12585,4088,274,16947,1,0.7426093113825456
54101,R,2759,610,33,3402,1,0.8109935332157554
54103,R,4993,1539,135,6667,1,0.7489125543722814
54105,R,2134,466,53,2653,1,0.8043724085940445
54107,R,27202,10926,634,38762,1,0.7017697745214385
54109,R,7353,1157,82,8592,1,0.8557960893854749
55001,D,7362,4329,115,11806,0,0.6235812298831103
55003,D,3841,4801,92,8734,0,0.4397755896496451
55005,D,15803,9194,320,25317,0,0.6242050795907887
55007,D,4617,6147,104,10868,0,0.42482517482517484
55009,D,75871,65511,2250,143632,0,0.5282318703353013
55011,D,4834,2860,110,7804,0,0.6194259354177345
55013,D,6462,3569,108,10139,0,0.6373409606470066
55015,D,18156,12116,480,30752,0,0.5904006243496358
55017,D,21317,13983,606,35906,0,0.5936890770344789
55019,D,10002,4524,347,14873,0,0.6724937806763934
55021,D,16927,16410,514,33851,0,0.5000443118371688
55023,D,4620,3953,122,8695,0,0.5313398504887866
55025,D,78794,260121,4654,343569,0,0.22933966685003596
55027,D,31355,16356,706,48417,0,0.6476031146085053
55029,D,9752,10044,280,20076,0,0.48575413428969916
55031,D,10923,13218,462,24603,0,0.44397024753078895
55033,D,13173,9897,440,23510,0,0.5603147596767333
55035,D,25341,31620,1113,58074,0,0.4363570616799256
55037,D,2133,781,26,2940,0,0.7255102040816327
55039,D,35754,20588,852,57194,0,0.6251355037241668
55041,D,3285,1721,43,5049,0,0.6506238859180036
55043,D,14142,10998,418,25558,0,0.5533296815087253
55045,D,10169,10851,336,21356,0,0.476165948679528
55047,D,7168,3344,136,10648,0,0.6731780616078137
55049,D,5909,7828,230,13967,0,0.42306866184577935
55051,D,2438,1533,33,4004,0,0.6088911088911089
55053,D,5791,4256,136,10183,0,0.5686929195718354
55055,D,27208,19904,747,47859,0,0.5685033118117805
55057,D,8749,4746,188,13683,0,0.6394065628882555
55059,D,44972,42193,1304,88469,0,0.508336253376889
55061,D,7927,3976,165,12068,0,0.6568611203181969
55063,D,28684,37846,1133,67663,0,0.42392444910807975
55065,D,4821,3647,81,8549,0,0.5639256053339572
55067,D,7330,3704,127,11161,0,0.6567511871696085
55069,D,10017,6261,219,16497,0,0.6072013093289689
55071,D,27218,16818,715,44751,0,0.608209872405086
55073,D,44624,30808,1173,76605,0,0.5825207231903923
55075,D,15304,7366,302,22972,0,0.6662023332752917
55077,D,5719,3239,92,9050,0,0.6319337016574585
55078,D,278,1303,9,1590,0,0.17484276729559747
55079,D,134482,317527,5718,457727,0,0.29380394864187603
55081,D,13775,8433,359,22567,0,0.6104045730491425
55083,D,16226,6715,270,23211,0,0.699065098444703
55085,D,13671,10105,343,24119,0,0.5668145445499398
55087,D,58385,47667,1918,107970,0,0.5407520607576178
55089,D,33912,26517,818,61247,0,0.5536924257514654
55091,D,2584,1489,68,4141,0,0.6240038638010142
55093,D,12815,9796,658,23269,0,0.5507327345395161
55095,D,16611,9370,378,26359,0,0.6301832391213628
55097,D,19299,20428,774,40501,0,0.476506752919681
55099,D,5394,3032,117,8543,0,0.6313941238440829
55101,D,54479,50159,1519,106157,0,0.5131927239842874
55103,D,4871,3995,136,9002,0,0.5411019773383693
55105,D,37138,46658,1368,85164,0,0.4360762763609037
55107,D,5257,2517,105,7879,0,0.6672166518593731
55109,D,32199,23190,1162,56551,0,0.5693798518151757
55111,D,17493,18108,580,36181,0,0.48348580746800807
55113,D,5909,4498,85,10492,0,0.5631910026686999
55115,D,15173,7131,303,22607,0,0.6711637988233733
55117,D,37609,27101,1119,65829,0,0.5713135548162663
55119,D,7657,2693,329,10679,0,0.7170147017511003
55121,D,8833,6285,236,15354,0,0.575289826755243
55123,D,8218,7457,235,15910,0,0.5165304839723445
55125,D,9261,5903,174,15338,0,0.6037944973269005
55127,D,33851,22789,814,57454,0,0.5891843909910537
55129,D,6334,3867,155,10356,0,0.6116261104673619
55131,D,60237,26650,1144,88031,0,0.684270313866706
55133,D,159649,103906,3659,267214,0,0.5974574685458097
55135,D,18952,9703,434,29089,0,0.6515177558527279
55137,D,9016,4388,164,13568,0,0.6645047169811321
55139,D,47796,44060,1935,93791,0,0.5096011344372061
55141,D,24308,16365,531,41204,0,0.5899427240073779
56001,R,8579,9092,773,18444,1,0.465137714161787
56003,R,4806,788,120,5714,1,0.8410920546027302
56005,R,16975,1935,554,19464,1,0.8721228935470613
56007,R,5014,1427,191,6632,1,0.7560313630880579
56009,R,5917,861,164,6942,1,0.8523480265053299
56011,R,3651,378,76,4105,1,0.8894031668696711
56013,R,12007,5519,478,18004,1,0.6669073539213508
56015,R,4878,1203,129,6210,1,0.7855072463768116
56017,R,1999,482,85,2566,1,0.779033515198753
56019,R,3881,897,113,4891,1,0.7934982621140871
56021,R,27891,15217,1554,44662,1,0.6244906184228203
56023,R,8643,1509,238,10390,1,0.8318575553416747
56025,R,25271,8530,1189,34990,1,0.7222349242640754
56027,R,1118,155,32,1305,1,0.8567049808429119
56029,R,12813,3410,379,16602,1,0.771774485001807
56031,R,3898,890,114,4902,1,0.7951856385148919
56033,R,11843,4043,453,16339,1,0.7248301609645633
56035,R,3957,882,108,4947,1,0.7998787143723469
56037,R,12229,3823,468,16520,1,0.7402542372881356
56039,R,4341,9848,344,14533,1,0.2986995114566848
56041,R,7496,1591,251,9338,1,0.8027414863996574
56043,R,3245,651,97,3993,1,0.8126721763085399
56045,R,3107,360,66,3533,1,0.8794225870365129
